CPRO,PROVINCIA,CMUN,municipi INE,POB19,HOMBRES,MUJERES,CODIGO INE 5,municipi GENCAT,DONA,taxa 1.000 hab dona,HOME,taxa 1.000 hab home,Suma total,taxa 1.000 hab total,municipi IDESCAT,comarca,codi municipi,població
08,Barcelona,001,Abrera,12489,6326,6163,08001,Abrera,22,"3,6",15,"2,4",37,"3,0",Abrera,Baix Llobregat,80018,12489
08,Barcelona,002,Aguilar de Segarra,288,155,133,08002,Aguilar de Segarra,1,"7,5",0,"0,0",1,"3,5",Aguilar de Segarra,Bages,80023,288
08,Barcelona,014,Aiguafreda,2504,1208,1296,08014,Aiguafreda,8,"6,2",3,"2,5",11,"4,4",Aiguafreda,Vallès Oriental,80142,2504
08,Barcelona,003,Alella,9801,4762,5039,08003,Alella,24,"4,8",22,"4,6",46,"4,7",Alella,Maresme,80039,9801
08,Barcelona,004,Alpens,266,144,122,08004,Alpens,0,"0,0",0,"0,0",0,"0,0",Alpens,Osona,80044,266
08,Barcelona,005,"Ametlla del Vallès, L'",8462,4277,4185,08005,L'Ametlla del Vallès,8,"1,9",8,"1,9",16,"1,9","Ametlla del Vallès, l'",Vallès Oriental,80057,8462
08,Barcelona,006,Arenys de Mar,15776,7683,8093,08006,Arenys de Mar,45,"5,6",24,"3,1",69,"4,4",Arenys de Mar,Maresme,80060,15776
08,Barcelona,007,Arenys de Munt,8931,4483,4448,08007,Arenys de Munt,13,"2,9",15,"3,3",28,"3,1",Arenys de Munt,Maresme,80076,8931
08,Barcelona,008,Argençola,217,110,107,08008,Argençola,0,"0,0",0,"0,0",0,"0,0",Argençola,Anoia,80082,217
08,Barcelona,009,Argentona,12452,6132,6320,08009,Argentona,23,"3,6",21,"3,4",44,"3,5",Argentona,Maresme,80095,12452
08,Barcelona,010,Artés,5698,2868,2830,08010,Artés,9,"3,2",7,"2,4",16,"2,8",Artés,Bages,80109,5698
08,Barcelona,011,Avià,2226,1121,1105,08011,Avià,5,"4,5",7,"6,2",12,"5,4",Avià,Berguedà,80116,2226
08,Barcelona,012,Avinyó,2275,1127,1148,08012,Avinyó,1,"0,9",0,"0,0",1,"0,4",Avinyó,Bages,80121,2275
08,Barcelona,013,Avinyonet del Penedès,1701,903,798,08013,Avinyonet del Penedès,1,"1,3",4,"4,4",5,"2,9",Avinyonet del Penedès,Alt Penedès,80137,1701
08,Barcelona,015,Badalona,220440,108509,111931,08015,Badalona,544,"4,9",561,"5,2",1105,"5,0",Badalona,Barcelonès,80155,220440
08,Barcelona,904,Badia del Vallès,13380,6567,6813,08904,Badia del Vallès,36,"5,3",23,"3,5",59,"4,4",Badia del Vallès,Vallès Occidental,89045,13380
08,Barcelona,016,Bagà,2138,1064,1074,08016,Bagà,8,"7,4",12,"11,3",20,"9,4",Bagà,Berguedà,80168,2138
08,Barcelona,017,Balenyà,3821,1928,1893,08017,Balenyà,31,"16,4",11,"5,7",42,"11,0",Balenyà,Osona,80174,3821
08,Barcelona,018,Balsareny,3159,1562,1597,08018,Balsareny,6,"3,8",3,"1,9",9,"2,8",Balsareny,Bages,80180,3159
08,Barcelona,252,Barberà del Vallès,33091,16300,16791,08252,Barberà del Vallès,111,"6,6",81,"5,0",192,"5,8",Barberà del Vallès,Vallès Occidental,82520,33091
08,Barcelona,019,Barcelona,1636762,775619,861143,08019,Barcelona,3766,"4,4",3597,"4,6",7363,"4,5",Barcelona,Barcelonès,80193,1636762
08,Barcelona,020,Begues,7098,3528,3570,08020,Begues,9,"2,5",12,"3,4",21,"3,0",Begues,Baix Llobregat,80207,7098
08,Barcelona,021,Bellprat,64,41,23,08021,Bellprat,0,"0,0",0,"0,0",0,"0,0",Bellprat,Anoia,80214,64
08,Barcelona,022,Berga,16494,8166,8328,08022,Berga,45,"5,4",31,"3,8",76,"4,6",Berga,Berguedà,80229,16494
08,Barcelona,023,Bigues i Riells,9092,4645,4447,08023,Bigues i Riells,12,"2,7",8,"1,7",20,"2,2",Bigues i Riells,Vallès Oriental,80235,9092
08,Barcelona,024,Borredà,445,253,192,08024,Borredà,0,"0,0",0,"0,0",0,"0,0",Borredà,Berguedà,80240,445
08,Barcelona,025,"Bruc, El",2050,1107,943,08025,El Bruc,3,"3,2",3,"2,7",6,"2,9","Bruc, el",Anoia,80253,2050
08,Barcelona,026,"Brull, El",263,145,118,08026,El Brull,1,"8,5",0,"0,0",1,"3,8","Brull, el",Osona,80266,263
08,Barcelona,027,"Cabanyes, Les",964,488,476,08027,Les Cabanyes,2,"4,2",0,"0,0",2,"2,1","Cabanyes, les",Alt Penedès,80272,964
08,Barcelona,028,Cabrera d'Anoia,1410,769,641,08028,Cabrera d'Anoia,2,"3,1",2,"2,6",4,"2,8",Cabrera d'Anoia,Anoia,80288,1410
08,Barcelona,029,Cabrera de Mar,4680,2348,2332,08029,Cabrera de Mar,6,"2,6",5,"2,1",11,"2,4",Cabrera de Mar,Maresme,80291,4680
08,Barcelona,030,Cabrils,7439,3682,3757,08030,Cabrils,8,"2,1",10,"2,7",18,"2,4",Cabrils,Maresme,80305,7439
08,Barcelona,031,Calaf,3535,1775,1760,08031,Calaf,3,"1,7",7,"3,9",10,"2,8",Calaf,Anoia,80312,3535
08,Barcelona,034,Calders,970,499,471,08034,Calders,2,"4,2",3,"6,0",5,"5,2",Calders,Moianès,80348,970
08,Barcelona,033,Caldes de Montbui,17554,8745,8809,08033,Caldes de Montbui,34,"3,9",27,"3,1",61,"3,5",Caldes de Montbui,Vallès Oriental,80333,17554
08,Barcelona,032,Caldes d'Estrac,2982,1426,1556,08032,Caldes d'Estrac,5,"3,2",4,"2,8",9,"3,0",Caldes d'Estrac,Maresme,80327,2982
08,Barcelona,035,Calella,19069,9339,9730,08035,Calella,19,"2,0",21,"2,2",40,"2,1",Calella,Maresme,80351,19069
08,Barcelona,037,Calldetenes,2489,1259,1230,08037,Calldetenes,13,"10,6",13,"10,3",26,"10,4",Calldetenes,Osona,80370,2489
08,Barcelona,038,Callús,2140,1061,1079,08038,Callús,1,"0,9",2,"1,9",3,"1,4",Callús,Bages,80386,2140
08,Barcelona,036,Calonge de Segarra,188,92,96,08036,Calonge de Segarra,0,"0,0",1,"10,9",1,"5,3",Calonge de Segarra,Anoia,80364,188
08,Barcelona,039,Campins,529,277,252,08039,Campins,2,"7,9",0,"0,0",2,"3,8",Campins,Vallès Oriental,80399,529
08,Barcelona,040,Canet de Mar,14526,7068,7458,08040,Canet de Mar,19,"2,5",9,"1,3",28,"1,9",Canet de Mar,Maresme,80403,14526
08,Barcelona,041,Canovelles,16629,8613,8016,08041,Canovelles,15,"1,9",21,"2,4",36,"2,2",Canovelles,Vallès Oriental,80410,16629
08,Barcelona,042,Cànoves i Samalús,3117,1581,1536,08042,Cànoves i Samalús,5,"3,3",6,"3,8",11,"3,5",Cànoves i Samalús,Vallès Oriental,80425,3117
08,Barcelona,043,Canyelles,4647,2414,2233,08043,Canyelles,4,"1,8",4,"1,7",8,"1,7",Canyelles,Garraf,80431,4647
08,Barcelona,044,Capellades,5293,2636,2657,08044,Capellades,17,"6,4",24,"9,1",41,"7,7",Capellades,Anoia,80446,5293
08,Barcelona,045,Capolat,94,44,50,08045,Capolat,0,"0,0",0,"0,0",0,"0,0",Capolat,Berguedà,80459,94
08,Barcelona,046,Cardedeu,18357,8957,9400,08046,Cardedeu,23,"2,4",21,"2,3",44,"2,4",Cardedeu,Vallès Oriental,80462,18357
08,Barcelona,047,Cardona,4636,2273,2363,08047,Cardona,29,"12,3",16,"7,0",45,"9,7",Cardona,Bages,80478,4636
08,Barcelona,048,Carme,765,396,369,08048,Carme,2,"5,4",4,"10,1",6,"7,8",Carme,Anoia,80484,765
08,Barcelona,049,Casserres,1608,813,795,08049,Casserres,0,"0,0",2,"2,5",2,"1,2",Casserres,Berguedà,80497,1608
08,Barcelona,057,Castell de l'Areny,68,38,30,08057,Castell de l'Areny,0,"0,0",0,"0,0",0,"0,0",Castell de l'Areny,Berguedà,80575,68
08,Barcelona,052,Castellar de n'Hug,159,85,74,08052,Castellar de n'Hug,0,"0,0",0,"0,0",0,"0,0",Castellar de n'Hug,Berguedà,80522,159
08,Barcelona,050,Castellar del Riu,169,94,75,08050,Castellar del Riu,0,"0,0",0,"0,0",0,"0,0",Castellar del Riu,Berguedà,80500,169
08,Barcelona,051,Castellar del Vallès,24187,11948,12239,08051,Castellar del Vallès,64,"5,2",39,"3,3",103,"4,3",Castellar del Vallès,Vallès Occidental,80517,24187
08,Barcelona,053,Castellbell i el Vilar,3647,1863,1784,08053,Castellbell i el Vilar,5,"2,8",1,"0,5",6,"1,6",Castellbell i el Vilar,Bages,80538,3647
08,Barcelona,054,Castellbisbal,12390,6238,6152,08054,Castellbisbal,17,"2,8",19,"3,0",36,"2,9",Castellbisbal,Vallès Occidental,80543,12390
08,Barcelona,055,Castellcir,752,392,360,08055,Castellcir,1,"2,8",0,"0,0",1,"1,3",Castellcir,Moianès,80556,752
08,Barcelona,056,Castelldefels,67004,33018,33986,08056,Castelldefels,87,"2,6",85,"2,6",172,"2,6",Castelldefels,Baix Llobregat,80569,67004
08,Barcelona,058,Castellet i la Gornal,2292,1180,1112,08058,Castellet i la Gornal,2,"1,8",1,"0,8",3,"1,3",Castellet i la Gornal,Alt Penedès,80581,2292
08,Barcelona,060,Castellfollit de Riubregós,151,86,65,08060,Castellfollit de Riubregós,0,"0,0",0,"0,0",0,"0,0",Castellfollit de Riubregós,Anoia,80608,151
08,Barcelona,059,Castellfollit del Boix,436,222,214,08059,Castellfollit del Boix,0,"0,0",0,"0,0",0,"0,0",Castellfollit del Boix,Bages,80594,436
08,Barcelona,061,Castellgalí,2062,1062,1000,08061,Castellgalí,3,"3,0",6,"5,6",9,"4,4",Castellgalí,Bages,80615,2062
08,Barcelona,062,Castellnou de Bages,1397,732,665,08062,Castellnou de Bages,0,"0,0",0,"0,0",0,"0,0",Castellnou de Bages,Bages,80620,1397
08,Barcelona,063,Castellolí,619,302,317,08063,Castellolí,2,"6,3",2,"6,6",4,"6,5",Castellolí,Anoia,80636,619
08,Barcelona,064,Castellterçol,2463,1236,1227,08064,Castellterçol,2,"1,6",1,"0,8",3,"1,2",Castellterçol,Moianès,80641,2463
08,Barcelona,065,Castellví de la Marca,1535,771,764,08065,Castellví de la Marca,0,"0,0",0,"0,0",0,"0,0",Castellví de la Marca,Alt Penedès,80654,1535
08,Barcelona,066,Castellví de Rosanes,1884,931,953,08066,Catellví de Rosanes,4,"4,2",3,"3,2",7,"3,7",Castellví de Rosanes,Baix Llobregat,80667,1884
08,Barcelona,067,Centelles,7404,3630,3774,08067,Centelles,10,"2,6",8,"2,2",18,"2,4",Centelles,Osona,80673,7404
08,Barcelona,268,Cercs,1145,577,568,08268,Cercs,2,"3,5",4,"6,9",6,"5,2",Cercs,Berguedà,82687,1145
08,Barcelona,266,Cerdanyola del Vallès,57403,28038,29365,08266,Cerdanyola del Vallès,136,"4,6",141,"5,0",277,"4,8",Cerdanyola del Vallès,Vallès Occidental,82665,57403
08,Barcelona,068,Cervelló,9054,4529,4525,08068,Cervelló,12,"2,7",14,"3,1",26,"2,9",Cervelló,Baix Llobregat,80689,9054
08,Barcelona,069,Collbató,4466,2320,2146,08069,Collbató,3,"1,4",6,"2,6",9,"2,0",Collbató,Baix Llobregat,80692,4466
08,Barcelona,070,Collsuspina,342,174,168,08070,Collsuspina,1,"6,0",0,"0,0",1,"2,9",Collsuspina,Moianès,80706,342
08,Barcelona,071,Copons,310,152,158,08071,Copons,0,"0,0",1,"6,6",1,"3,2",Copons,Anoia,80713,310
08,Barcelona,072,Corbera de Llobregat,14822,7449,7373,08072,Corbera de Llobregat,33,"4,5",14,"1,9",47,"3,2",Corbera de Llobregat,Baix Llobregat,80728,14822
08,Barcelona,073,Cornellà de Llobregat,88592,42945,45647,08073,Cornellà de Llobregat,155,"3,4",124,"2,9",279,"3,1",Cornellà de Llobregat,Baix Llobregat,80734,88592
08,Barcelona,074,Cubelles,15329,7687,7642,08074,Cubelles,10,"1,3",14,"1,8",24,"1,6",Cubelles,Garraf,80749,15329
08,Barcelona,075,Dosrius,5481,2780,2701,08075,Dosrius,9,"3,3",3,"1,1",12,"2,2",Dosrius,Maresme,80752,5481
08,Barcelona,076,Esparreguera,22251,11249,11002,08076,Esparreguera,22,"2,0",27,"2,4",49,"2,2",Esparreguera,Baix Llobregat,80765,22251
08,Barcelona,077,Esplugues de Llobregat,46680,22300,24380,08077,Esplugues de Llobregat,83,"3,4",77,"3,5",160,"3,4",Esplugues de Llobregat,Baix Llobregat,80771,46680
08,Barcelona,078,"Espunyola, L'",254,126,128,08078,L'Espunyola,0,"0,0",0,"0,0",0,"0,0","Espunyola, l'",Berguedà,80787,254
08,Barcelona,254,"Esquirol, L'",2181,1105,1076,08254,L'Esquirol,8,"7,4",5,"4,5",13,"6,0","Esquirol, l'",Osona,82541,2181
08,Barcelona,079,"Estany, L'",406,205,201,08079,L'Estany,0,"0,0",0,"0,0",0,"0,0","Estany, l'",Moianès,80790,406
08,Barcelona,134,Figaró-Montmany,1114,547,567,08134,Figaró-Montmany,13,"22,9",5,"9,1",18,"16,2",Figaró-Montmany,Vallès Oriental,81347,1114
08,Barcelona,080,Fígols,42,25,17,08080,Fígols,0,"0,0",0,"0,0",0,"0,0",Fígols,Berguedà,80804,42
08,Barcelona,082,Fogars de la Selva,1451,748,703,08082,Fogars de Tordera,1,"1,4",0,"0,0",1,"0,7",Fogars de la Selva,Selva,80826,1451
08,Barcelona,081,Fogars de Montclús,470,245,225,08081,Fogars de Montclús,1,"4,4",0,"0,0",1,"2,1",Fogars de Montclús,Vallès Oriental,80811,470
08,Barcelona,083,Folgueroles,2267,1159,1108,08083,Folgueroles,1,"0,9",0,"0,0",1,"0,4",Folgueroles,Osona,80832,2267
08,Barcelona,084,Fonollosa,1453,750,703,08084,Fonollosa,3,"4,3",1,"1,3",4,"2,8",Fonollosa,Bages,80847,1453
08,Barcelona,085,Font-rubí,1327,688,639,08085,Font-Rubí,3,"4,7",1,"1,5",4,"3,0",Font-rubí,Alt Penedès,80850,1327
08,Barcelona,086,"Franqueses del Vallès, Les",20092,10210,9882,08086,Les Franqueses del Vallès,27,"2,7",20,"2,0",47,"2,3","Franqueses del Vallès, les",Vallès Oriental,80863,20092
08,Barcelona,090,Gaià,175,97,78,08090,Gaià,0,"0,0",0,"0,0",0,"0,0",Gaià,Bages,80902,175
08,Barcelona,087,Gallifa,172,95,77,08087,Gallifa,0,"0,0",2,"21,1",2,"11,6",Gallifa,Vallès Occidental,80879,172
08,Barcelona,088,"Garriga, La",16514,7987,8527,08088,La Garriga,18,"2,1",25,"3,1",43,"2,6","Garriga, la",Vallès Oriental,80885,16514
08,Barcelona,089,Gavà,46771,22876,23895,08089,Gavà,155,"6,5",125,"5,5",280,"6,0",Gavà,Baix Llobregat,80898,46771
08,Barcelona,091,Gelida,7533,3778,3755,08091,Gelida,13,"3,5",5,"1,3",18,"2,4",Gelida,Alt Penedès,80919,7533
08,Barcelona,092,Gironella,4826,2384,2442,08092,Gironella,7,"2,9",7,"2,9",14,"2,9",Gironella,Berguedà,80924,4826
08,Barcelona,093,Gisclareny,25,15,10,08093,Gisclareny,0,"0,0",0,"0,0",0,"0,0",Gisclareny,Berguedà,80930,25
08,Barcelona,094,"Granada, La",2157,1092,1065,08094,La Granada,5,"4,7",3,"2,7",8,"3,7","Granada, la",Alt Penedès,80945,2157
08,Barcelona,095,Granera,69,53,16,08095,Granera,0,"0,0",0,"0,0",0,"0,0",Granera,Moianès,80958,69
08,Barcelona,096,Granollers,61275,30199,31076,08096,Granollers,99,"3,2",95,"3,1",194,"3,2",Granollers,Vallès Oriental,80961,61275
08,Barcelona,097,Gualba,1500,769,731,08097,Gualba,2,"2,7",1,"1,3",3,"2,0",Gualba,Vallès Oriental,80977,1500
08,Barcelona,099,Guardiola de Berguedà,908,464,444,08099,Guardiola de Berguedà,3,"6,8",2,"4,3",5,"5,5",Guardiola de Berguedà,Berguedà,80996,908
08,Barcelona,100,Gurb,2681,1386,1295,08100,Gurb,10,"7,7",2,"1,4",12,"4,5",Gurb,Osona,81000,2681
08,Barcelona,101,"Hospitalet de Llobregat, L'",264923,127981,136942,08101,L'Hospitalet de Llobregat,720,"5,3",704,"5,5",1424,"5,4","Hospitalet de Llobregat, l'",Barcelonès,81017,264923
08,Barcelona,162,"Hostalets de Pierola, Els",2973,1518,1455,08162,Els Hostalets de Pierola,6,"4,1",6,"4,0",12,"4,0","Hostalets de Pierola, els",Anoia,81629,2973
08,Barcelona,102,Igualada,39967,19636,20331,08102,Igualada,162,"8,0",141,"7,2",303,"7,6",Igualada,Anoia,81022,39967
08,Barcelona,103,Jorba,835,424,411,08103,Jorba,1,"2,4",4,"9,4",5,"6,0",Jorba,Anoia,81038,835
08,Barcelona,104,"Llacuna, La",870,475,395,08104,La Llacuna,2,"5,1",4,"8,4",6,"6,9","Llacuna, la",Anoia,81043,870
08,Barcelona,105,"Llagosta, La",13480,6675,6805,08105,La Llagosta,18,"2,6",24,"3,6",42,"3,1","Llagosta, la",Vallès Oriental,81056,13480
08,Barcelona,107,Lliçà d'Amunt,15256,7819,7437,08107,Lliçà d'Amunt,33,"4,4",11,"1,4",44,"2,9",Lliçà d'Amunt,Vallès Oriental,81075,15256
08,Barcelona,108,Lliçà de Vall,6542,3335,3207,08108,Lliçà de Vall,12,"3,7",7,"2,1",19,"2,9",Lliçà de Vall,Vallès Oriental,81081,6542
08,Barcelona,106,Llinars del Vallès,9938,4946,4992,08106,Llinars del Vallès,16,"3,2",21,"4,2",37,"3,7",Llinars del Vallès,Vallès Oriental,81069,9938
08,Barcelona,109,Lluçà,273,134,139,08109,Lluçà,0,"0,0",0,"0,0",0,"0,0",Lluçà,Osona,81094,273
08,Barcelona,110,Malgrat de Mar,18579,9280,9299,08110,Malgrat de Mar,25,"2,7",24,"2,6",49,"2,6",Malgrat de Mar,Maresme,81108,18579
08,Barcelona,111,Malla,273,139,134,08111,Malla,0,"0,0",0,"0,0",0,"0,0",Malla,Osona,81115,273
08,Barcelona,112,Manlleu,20573,10314,10259,08112,Manlleu,69,"6,7",46,"4,5",115,"5,6",Manlleu,Osona,81120,20573
08,Barcelona,113,Manresa,77714,38066,39648,08113,Manresa,132,"3,3",94,"2,5",226,"2,9",Manresa,Bages,81136,77714
08,Barcelona,242,Marganell,266,131,135,08242,Marganell,0,"0,0",0,"0,0",0,"0,0",Marganell,Bages,82423,266
08,Barcelona,114,Martorell,28189,14329,13860,08114,Martorell,62,"4,5",46,"3,2",108,"3,8",Martorell,Baix Llobregat,81141,28189
08,Barcelona,115,Martorelles,4801,2422,2379,08115,Martorelles,10,"4,2",6,"2,5",16,"3,3",Martorelles,Vallès Oriental,81154,4801
08,Barcelona,116,"Masies de Roda, Les",700,355,345,08116,Les Masies de Roda,2,"5,8",1,"2,8",3,"4,3","Masies de Roda, les",Osona,81167,700
08,Barcelona,117,"Masies de Voltregà, Les",3141,1551,1590,08117,Les Masies de Voltregà,8,"5,0",4,"2,6",12,"3,8","Masies de Voltregà, les",Osona,81173,3141
08,Barcelona,118,"Masnou, El",23515,11357,12158,08118,El Masnou,36,"3,0",36,"3,2",72,"3,1","Masnou, el",Maresme,81189,23515
08,Barcelona,119,Masquefa,9211,4641,4570,08119,Masquefa,10,"2,2",9,"1,9",19,"2,1",Masquefa,Anoia,81192,9211
08,Barcelona,120,Matadepera,9326,4657,4669,08120,Matadepera,26,"5,6",20,"4,3",46,"4,9",Matadepera,Vallès Occidental,81206,9326
08,Barcelona,121,Mataró,128265,63637,64628,08121,Mataró,182,"2,8",154,"2,4",336,"2,6",Mataró,Maresme,81213,128265
08,Barcelona,122,Mediona,2322,1159,1163,08122,Mediona,63,"54,2",17,"14,7",80,"34,5",Mediona,Alt Penedès,81228,2322
08,Barcelona,138,Moià,6267,3190,3077,08138,Moià,11,"3,6",5,"1,6",16,"2,6",Moià,Moianès,81385,6267
08,Barcelona,123,Molins de Rei,25868,12612,13256,08123,Molins de Rei,23,"1,7",23,"1,8",46,"1,8",Molins de Rei,Baix Llobregat,81234,25868
08,Barcelona,124,Mollet del Vallès,51318,25222,26096,08124,Mollet del Vallès,192,"7,4",147,"5,8",339,"6,6",Mollet del Vallès,Vallès Oriental,81249,51318
08,Barcelona,128,Monistrol de Calders,682,357,325,08128,Monistrol de Calders,1,"3,1",2,"5,6",3,"4,4",Monistrol de Calders,Moianès,81287,682
08,Barcelona,127,Monistrol de Montserrat,3034,1551,1483,08127,Monistrol de Montserrat,2,"1,3",2,"1,3",4,"1,3",Monistrol de Montserrat,Bages,81271,3034
08,Barcelona,125,Montcada i Reixac,36239,17901,18338,08125,Montcada i Reixac,82,"4,5",66,"3,7",148,"4,1",Montcada i Reixac,Vallès Occidental,81252,36239
08,Barcelona,130,Montclar,136,71,65,08130,Montclar,0,"0,0",0,"0,0",0,"0,0",Montclar,Berguedà,81304,136
08,Barcelona,131,Montesquiu,998,501,497,08131,Montesquiu,6,"12,1",4,"8,0",10,"10,0",Montesquiu,Osona,81311,998
08,Barcelona,126,Montgat,12041,5938,6103,08126,Montgat,17,"2,8",25,"4,2",42,"3,5",Montgat,Maresme,81265,12041
08,Barcelona,132,Montmajor,464,231,233,08132,Montmajor,0,"0,0",1,"4,3",1,"2,2",Montmajor,Berguedà,81326,464
08,Barcelona,133,Montmaneu,150,83,67,08133,Montmaneu,0,"0,0",0,"0,0",0,"0,0",Montmaneu,Anoia,81332,150
08,Barcelona,135,Montmeló,8755,4275,4480,08135,Montmeló,17,"3,8",13,"3,0",30,"3,4",Montmeló,Vallès Oriental,81350,8755
08,Barcelona,136,Montornès del Vallès,16393,8251,8142,08136,Montornès del Vallès,38,"4,7",60,"7,3",98,"6,0",Montornès del Vallès,Vallès Oriental,81363,16393
08,Barcelona,137,Montseny,342,179,163,08137,Montseny,0,"0,0",0,"0,0",0,"0,0",Montseny,Vallès Oriental,81379,342
08,Barcelona,129,Muntanyola,634,321,313,08129,Muntanyola,1,"3,2",0,"0,0",1,"1,6",Muntanyola,Osona,81290,634
08,Barcelona,139,Mura,224,122,102,08139,Mura,0,"0,0",0,"0,0",0,"0,0",Mura,Bages,81398,224
08,Barcelona,140,Navarcles,5977,2914,3063,08140,Navarcles,16,"5,2",11,"3,8",27,"4,5",Navarcles,Bages,81402,5977
08,Barcelona,141,Navàs,6020,2998,3022,08141,Navàs,13,"4,3",15,"5,0",28,"4,7",Navàs,Bages,81419,6020
08,Barcelona,142,"Nou de Berguedà, La",161,83,78,08142,La Nou de Berguedà,0,"0,0",0,"0,0",0,"0,0","Nou de Berguedà, la",Berguedà,81424,161
08,Barcelona,143,Òdena,3643,1848,1795,08143,Òdena,7,"3,9",10,"5,4",17,"4,7",Òdena,Anoia,81430,3643
08,Barcelona,145,Olèrdola,3692,1900,1792,08145,Olèrdola,1,"0,6",0,"0,0",1,"0,3",Olèrdola,Alt Penedès,81458,3692
08,Barcelona,146,Olesa de Bonesvalls,1810,949,861,08146,Olesa de Bonesvalls,2,"2,3",0,"0,0",2,"1,1",Olesa de Bonesvalls,Alt Penedès,81461,1810
08,Barcelona,147,Olesa de Montserrat,23904,11913,11991,08147,Olesa de Montserrat,64,"5,3",39,"3,3",103,"4,3",Olesa de Montserrat,Baix Llobregat,81477,23904
08,Barcelona,148,Olivella,3799,1985,1814,08148,Olivella,0,"0,0",1,"0,5",1,"0,3",Olivella,Garraf,81483,3799
08,Barcelona,149,Olost,1198,588,610,08149,Olost,2,"3,3",2,"3,4",4,"3,3",Olost,Osona,81496,1198
08,Barcelona,144,Olvan,854,416,438,08144,Olvan,0,"0,0",3,"7,2",3,"3,5",Olvan,Berguedà,81445,854
08,Barcelona,150,Orís,315,159,156,08150,Orís,2,"12,8",1,"6,3",3,"9,5",Orís,Osona,81509,315
08,Barcelona,151,Oristà,541,274,267,08151,Oristà,1,"3,7",1,"3,6",2,"3,7",Oristà,Osona,81516,541
08,Barcelona,152,Orpí,147,80,67,08152,Orpí,0,"0,0",0,"0,0",0,"0,0",Orpí,Anoia,81521,147
08,Barcelona,153,Òrrius,739,381,358,08153,Òrrius,0,"0,0",0,"0,0",0,"0,0",Òrrius,Maresme,81537,739
08,Barcelona,154,Pacs del Penedès,922,469,453,08154,Pacs del Penedès,1,"2,2",1,"2,1",2,"2,2",Pacs del Penedès,Alt Penedès,81542,922
08,Barcelona,155,Palafolls,9405,4690,4715,08155,Palafolls,6,"1,3",5,"1,1",11,"1,2",Palafolls,Maresme,81555,9405
08,Barcelona,156,Palau-solità i Plegamans,14771,7246,7525,08156,Palau-Solità i Plegamans,24,"3,2",21,"2,9",45,"3,0",Palau-solità i Plegamans,Vallès Occidental,81568,14771
08,Barcelona,157,Pallejà,11508,5728,5780,08157,Pallejà,31,"5,4",19,"3,3",50,"4,3",Pallejà,Baix Llobregat,81574,11508
08,Barcelona,905,"Palma de Cervelló, La",2954,1460,1494,08905,La Palma de Cervelló,0,"0,0",1,"0,7",1,"0,3","Palma de Cervelló, la",Baix Llobregat,89058,2954
08,Barcelona,158,"Papiol, El",4145,2052,2093,08158,El Papiol,4,"1,9",3,"1,5",7,"1,7","Papiol, el",Baix Llobregat,81580,4145
08,Barcelona,159,Parets del Vallès,19082,9541,9541,08159,Parets del Vallès,62,"6,5",40,"4,2",102,"5,3",Parets del Vallès,Vallès Oriental,81593,19082
08,Barcelona,160,Perafita,395,202,193,08160,Perafita,0,"0,0",0,"0,0",0,"0,0",Perafita,Osona,81607,395
08,Barcelona,161,Piera,15603,7976,7627,08161,Piera,25,"3,3",39,"4,9",64,"4,1",Piera,Anoia,81614,15603
08,Barcelona,163,Pineda de Mar,27272,13588,13684,08163,Pineda de Mar,18,"1,3",15,"1,1",33,"1,2",Pineda de Mar,Maresme,81635,27272
08,Barcelona,164,"Pla del Penedès, El",1256,636,620,08164,El Pla del Penedès,0,"0,0",0,"0,0",0,"0,0","Pla del Penedès, el",Alt Penedès,81640,1256
08,Barcelona,165,"Pobla de Claramunt, La",2193,1104,1089,08165,La Pobla de Claramunt,4,"3,7",7,"6,3",11,"5,0","Pobla de Claramunt, la",Anoia,81653,2193
08,Barcelona,166,"Pobla de Lillet, La",1095,528,567,08166,La Pobla de Lillet,0,"0,0",1,"1,9",1,"0,9","Pobla de Lillet, la",Berguedà,81666,1095
08,Barcelona,167,Polinyà,8479,4295,4184,08167,Polinyà,15,"3,6",10,"2,3",25,"2,9",Polinyà,Vallès Occidental,81672,8479
08,Barcelona,182,"Pont de Vilomara i Rocafort, El",3830,1969,1861,08182,El Pont de Vilomara i Rocafort,8,"4,3",7,"3,6",15,"3,9","Pont de Vilomara i Rocafort, el",Bages,81825,3830
08,Barcelona,168,Pontons,532,289,243,08168,Pontons,0,"0,0",0,"0,0",0,"0,0",Pontons,Alt Penedès,81688,532
08,Barcelona,169,"Prat de Llobregat, El",64599,31621,32978,08169,El Prat de Llobregat,204,"6,2",199,"6,3",403,"6,2","Prat de Llobregat, el",Baix Llobregat,81691,64599
08,Barcelona,171,Prats de Lluçanès,2569,1280,1289,08171,Prats de Lluçanès,2,"1,6",3,"2,3",5,"1,9",Prats de Lluçanès,Osona,81712,2569
08,Barcelona,170,"Prats de Rei, Els",532,283,249,08170,Els Prats de Rei,0,"0,0",1,"3,5",1,"1,9","Prats de Rei, els",Anoia,81705,532
08,Barcelona,230,Premià de Dalt,10448,5207,5241,08230,Premià de Dalt,15,"2,9",17,"3,3",32,"3,1",Premià de Dalt,Maresme,82303,10448
08,Barcelona,172,Premià de Mar,28119,13704,14415,08172,Premià de Mar,48,"3,3",52,"3,8",100,"3,6",Premià de Mar,Maresme,81727,28119
08,Barcelona,174,Puigdàlber,526,256,270,08174,Puigdàlber,2,"7,4",0,"0,0",2,"3,8",Puigdàlber,Alt Penedès,81748,526
08,Barcelona,175,Puig-reig,4178,2086,2092,08175,Puig-Reig,4,"1,9",3,"1,4",7,"1,7",Puig-reig,Berguedà,81751,4178
08,Barcelona,176,Pujalt,210,119,91,08176,Pujalt,0,"0,0",0,"0,0",0,"0,0",Pujalt,Anoia,81764,210
08,Barcelona,177,"Quar, La",53,29,24,08177,"Quar, La",0,"0,0",0,"0,0",0,"0,0","Quar, la",Berguedà,81770,53
08,Barcelona,178,Rajadell,548,275,273,08178,Rajadell,0,"0,0",1,"3,6",1,"1,8",Rajadell,Bages,81786,548
08,Barcelona,179,Rellinars,780,403,377,08179,Rellinars,1,"2,7",0,"0,0",1,"1,3",Rellinars,Vallès Occidental,81799,780
08,Barcelona,180,Ripollet,38665,19080,19585,08180,Ripollet,68,"3,5",78,"4,1",146,"3,8",Ripollet,Vallès Occidental,81803,38665
08,Barcelona,181,"Roca del Vallès, La",10650,5319,5331,08181,La Roca del Vallès,7,"1,3",16,"3,0",23,"2,2","Roca del Vallès, la",Vallès Oriental,81810,10650
08,Barcelona,183,Roda de Ter,6301,3118,3183,08183,Roda de Ter,17,"5,3",6,"1,9",23,"3,7",Roda de Ter,Osona,81831,6301
08,Barcelona,184,Rubí,77464,38358,39106,08184,Rubí,173,"4,4",142,"3,7",315,"4,1",Rubí,Vallès Occidental,81846,77464
08,Barcelona,185,Rubió,239,133,106,08185,Rubió,0,"0,0",0,"0,0",0,"0,0",Rubió,Anoia,81859,239
08,Barcelona,901,Rupit i Pruit,279,139,140,08901,Rupit i Pruit,2,"14,3",0,"0,0",2,"7,2",Rupit i Pruit,Osona,89019,279
08,Barcelona,187,Sabadell,213644,103847,109797,08187,Sabadell,605,"5,5",591,"5,7",1196,"5,6",Sabadell,Vallès Occidental,81878,213644
08,Barcelona,188,Sagàs,148,80,68,08188,Sagàs,0,"0,0",0,"0,0",0,"0,0",Sagàs,Berguedà,81884,148
08,Barcelona,190,Saldes,274,159,115,08190,Saldes,1,"8,7",0,"0,0",1,"3,6",Saldes,Berguedà,81901,274
08,Barcelona,191,Sallent,6658,3211,3447,08191,Sallent,16,"4,6",6,"1,9",22,"3,3",Sallent,Bages,81918,6658
08,Barcelona,194,Sant Adrià de Besòs,37097,18251,18846,08194,Sant Adrià del Besòs,110,"5,8",77,"4,2",187,"5,0",Sant Adrià de Besòs,Barcelonès,81944,37097
08,Barcelona,195,Sant Agustí de Lluçanès,85,42,43,08195,Sant Agustí de Lluçanès,0,"0,0",0,"0,0",0,"0,0",Sant Agustí de Lluçanès,Osona,81957,85
08,Barcelona,196,Sant Andreu de la Barca,27558,13679,13879,08196,Sant Andreu de la Barca,48,"3,5",33,"2,4",81,"2,9",Sant Andreu de la Barca,Baix Llobregat,81960,27558
08,Barcelona,197,Sant Andreu de Llavaneres,10968,5424,5544,08197,Sant Andreu de Llavaneres,16,"2,9",23,"4,2",39,"3,6",Sant Andreu de Llavaneres,Maresme,81976,10968
08,Barcelona,198,Sant Antoni de Vilamajor,6135,3031,3104,08198,Sant Antoni de Vilamajor,16,"5,2",10,"3,3",26,"4,2",Sant Antoni de Vilamajor,Vallès Oriental,81982,6135
08,Barcelona,199,Sant Bartomeu del Grau,858,460,398,08199,Sant Bartomeu del Grau,0,"0,0",1,"2,2",1,"1,2",Sant Bartomeu del Grau,Osona,81995,858
08,Barcelona,200,Sant Boi de Llobregat,83605,40877,42728,08200,Sant Boi de Llobregat,270,"6,3",228,"5,6",498,"6,0",Sant Boi de Llobregat,Baix Llobregat,82009,83605
08,Barcelona,201,Sant Boi de Lluçanès,541,269,272,08201,Sant Boi de Lluçanès,0,"0,0",0,"0,0",0,"0,0",Sant Boi de Lluçanès,Osona,82016,541
08,Barcelona,203,Sant Cebrià de Vallalta,3385,1764,1621,08203,Sant Cebrià de Vallalta,0,"0,0",1,"0,6",1,"0,3",Sant Cebrià de Vallalta,Maresme,82037,3385
08,Barcelona,202,Sant Celoni,17904,8939,8965,08202,Sant Celoni,30,"3,3",15,"1,7",45,"2,5",Sant Celoni,Vallès Oriental,82021,17904
08,Barcelona,204,Sant Climent de Llobregat,4129,2075,2054,08204,Sant Climent de Llobregat,10,"4,9",15,"7,2",25,"6,1",Sant Climent de Llobregat,Baix Llobregat,82042,4129
08,Barcelona,205,Sant Cugat del Vallès,91006,44197,46809,08205,Sant Cugat del Vallès,160,"3,4",163,"3,7",323,"3,5",Sant Cugat del Vallès,Vallès Occidental,82055,91006
08,Barcelona,206,Sant Cugat Sesgarrigues,1007,488,519,08206,Sant Cugat Sesgarrigues,2,"3,9",2,"4,1",4,"4,0",Sant Cugat Sesgarrigues,Alt Penedès,82068,1007
08,Barcelona,207,Sant Esteve de Palautordera,2820,1391,1429,08207,Sant Esteve de Palautordera,6,"4,2",3,"2,2",9,"3,2",Sant Esteve de Palautordera,Vallès Oriental,82074,2820
08,Barcelona,208,Sant Esteve Sesrovires,7612,3835,3777,08208,Sant Esteve Sesrovires,35,"9,3",17,"4,4",52,"6,8",Sant Esteve Sesrovires,Baix Llobregat,82080,7612
08,Barcelona,210,Sant Feliu de Codines,6259,3168,3091,08210,Sant Feliu de Codines,8,"2,6",5,"1,6",13,"2,1",Sant Feliu de Codines,Vallès Oriental,82107,6259
08,Barcelona,211,Sant Feliu de Llobregat,44860,21767,23093,08211,Sant Feliu de Llobregat,59,"2,6",51,"2,3",110,"2,5",Sant Feliu de Llobregat,Baix Llobregat,82114,44860
08,Barcelona,212,Sant Feliu Sasserra,602,312,290,08212,Sant Feliu Sasserra,0,"0,0",0,"0,0",0,"0,0",Sant Feliu Sasserra,Bages,82129,602
08,Barcelona,209,Sant Fost de Campsentelles,8737,4352,4385,08209,Sant Fost de Campsentelles,17,"3,9",20,"4,6",37,"4,2",Sant Fost de Campsentelles,Vallès Oriental,82093,8737
08,Barcelona,213,Sant Fruitós de Bages,8703,4295,4408,08213,Sant Fruitós de Bages,35,"7,9",12,"2,8",47,"5,4",Sant Fruitós de Bages,Bages,82135,8703
08,Barcelona,215,Sant Hipòlit de Voltregà,3484,1729,1755,08215,Sant Hipòlit de Voltregà,14,"8,0",10,"5,8",24,"6,9",Sant Hipòlit de Voltregà,Osona,82153,3484
08,Barcelona,193,Sant Iscle de Vallalta,1332,687,645,08193,Sant Iscle de Vallalta,1,"1,6",1,"1,5",2,"1,5",Sant Iscle de Vallalta,Maresme,81939,1332
08,Barcelona,216,Sant Jaume de Frontanyà,30,18,12,08216,Sant Jaume de Frontanyà,0,"0,0",0,"0,0",0,"0,0",Sant Jaume de Frontanyà,Berguedà,82166,30
08,Barcelona,218,Sant Joan de Vilatorrada,10936,5490,5446,08218,Sant Joan de Vilatorrada,41,"7,5",26,"4,7",67,"6,1",Sant Joan de Vilatorrada,Bages,82188,10936
08,Barcelona,217,Sant Joan Despí,34123,16585,17538,08217,Sant Joan Despí,54,"3,1",35,"2,1",89,"2,6",Sant Joan Despí,Baix Llobregat,82172,34123
08,Barcelona,903,Sant Julià de Cerdanyola,228,125,103,08903,Sant Julià de Cerdanyola,0,"0,0",0,"0,0",0,"0,0",Sant Julià de Cerdanyola,Berguedà,89030,228
08,Barcelona,220,Sant Julià de Vilatorta,3114,1539,1575,08220,Sant Julià de Vilatorta,16,"10,2",10,"6,5",26,"8,3",Sant Julià de Vilatorta,Osona,82205,3114
08,Barcelona,221,Sant Just Desvern,17805,8544,9261,08221,Sant Just Desvern,46,"5,0",25,"2,9",71,"4,0",Sant Just Desvern,Baix Llobregat,82212,17805
08,Barcelona,222,Sant Llorenç d'Hortons,2413,1226,1187,08222,Sant Llorenç d'Hortons,3,"2,5",6,"4,9",9,"3,7",Sant Llorenç d'Hortons,Alt Penedès,82227,2413
08,Barcelona,223,Sant Llorenç Savall,2373,1197,1176,08223,Sant Llorenç Savall,29,"24,7",10,"8,4",39,"16,4",Sant Llorenç Savall,Vallès Occidental,82233,2373
08,Barcelona,225,Sant Martí d'Albars,112,56,56,08225,Sant Martí d'Albars,0,"0,0",0,"0,0",0,"0,0",Sant Martí d'Albars,Osona,82251,112
08,Barcelona,224,Sant Martí de Centelles,1167,600,567,08224,Sant Martí de Centelles,0,"0,0",1,"1,7",1,"0,9",Sant Martí de Centelles,Osona,82248,1167
08,Barcelona,226,Sant Martí de Tous,1235,637,598,08226,Sant Martí de Tous,2,"3,3",2,"3,1",4,"3,2",Sant Martí de Tous,Anoia,82264,1235
08,Barcelona,227,Sant Martí Sarroca,3264,1608,1656,08227,Sant Martí Sarroca,1,"0,6",3,"1,9",4,"1,2",Sant Martí Sarroca,Alt Penedès,82270,3264
08,Barcelona,228,Sant Martí Sesgueioles,343,176,167,08228,Sant Martí Sesgueioles,1,"6,0",0,"0,0",1,"2,9",Sant Martí Sesgueioles,Anoia,82286,343
08,Barcelona,229,Sant Mateu de Bages,603,302,301,08229,Sant Mateu de Bages,0,"0,0",1,"3,3",1,"1,7",Sant Mateu de Bages,Bages,82299,603
08,Barcelona,231,Sant Pere de Ribes,30719,15268,15451,08231,Sant Pere de Ribes,58,"3,8",31,"2,0",89,"2,9",Sant Pere de Ribes,Garraf,82310,30719
08,Barcelona,232,Sant Pere de Riudebitlles,2368,1181,1187,08232,Sant Pere de Riudebitlles,5,"4,2",1,"0,8",6,"2,5",Sant Pere de Riudebitlles,Alt Penedès,82325,2368
08,Barcelona,233,Sant Pere de Torelló,2419,1242,1177,08233,Sant Pere de Torelló,5,"4,2",5,"4,0",10,"4,1",Sant Pere de Torelló,Osona,82331,2419
08,Barcelona,234,Sant Pere de Vilamajor,4472,2239,2233,08234,Sant Pere de Vilamajor,6,"2,7",3,"1,3",9,"2,0",Sant Pere de Vilamajor,Vallès Oriental,82346,4472
08,Barcelona,189,Sant Pere Sallavinera,152,82,70,08189,Sant Pere Sallavinera,0,"0,0",0,"0,0",0,"0,0",Sant Pere Sallavinera,Anoia,81897,152
08,Barcelona,235,Sant Pol de Mar,5299,2604,2695,08235,Sant Pol de Mar,7,"2,6",6,"2,3",13,"2,5",Sant Pol de Mar,Maresme,82359,5299
08,Barcelona,236,Sant Quintí de Mediona,2254,1154,1100,08236,Sant Quintí de Mediona,3,"2,7",3,"2,6",6,"2,7",Sant Quintí de Mediona,Alt Penedès,82362,2254
08,Barcelona,237,Sant Quirze de Besora,2167,1054,1113,08237,Sant Quirze de Besora,7,"6,3",4,"3,8",11,"5,1",Sant Quirze de Besora,Osona,82378,2167
08,Barcelona,238,Sant Quirze del Vallès,20141,9865,10276,08238,Sant Quirze del Vallès,102,"9,9",64,"6,5",166,"8,2",Sant Quirze del Vallès,Vallès Occidental,82384,20141
08,Barcelona,239,Sant Quirze Safaja,627,336,291,08239,Sant Quirze Safaja,0,"0,0",0,"0,0",0,"0,0",Sant Quirze Safaja,Moianès,82397,627
08,Barcelona,240,Sant Sadurní d'Anoia,12887,6348,6539,08240,Sant Sadurní d'Anoia,13,"2,0",10,"1,6",23,"1,8",Sant Sadurní d'Anoia,Alt Penedès,82401,12887
08,Barcelona,241,Sant Sadurní d'Osormort,78,47,31,08241,Sant Sadurní d'Osormort,0,"0,0",0,"0,0",0,"0,0",Sant Sadurní d'Osormort,Osona,82418,78
08,Barcelona,098,Sant Salvador de Guardiola,3179,1630,1549,08098,Sant Salvador de Guardiola,3,"1,9",4,"2,5",7,"2,2",Sant Salvador de Guardiola,Bages,80983,3179
08,Barcelona,262,Sant Vicenç de Castellet,9523,4760,4763,08262,Sant Vicenç de Castellet,9,"1,9",6,"1,3",15,"1,6",Sant Vicenç de Castellet,Bages,82628,9523
08,Barcelona,264,Sant Vicenç de Montalt,6407,3199,3208,08264,Sant Vicenç de Montalt,4,"1,2",8,"2,5",12,"1,9",Sant Vicenç de Montalt,Maresme,82649,6407
08,Barcelona,265,Sant Vicenç de Torelló,2058,1019,1039,08265,Sant Vicenç de Torelló,6,"5,8",1,"1,0",7,"3,4",Sant Vicenç de Torelló,Osona,82652,2058
08,Barcelona,263,Sant Vicenç dels Horts,28117,13959,14158,08263,Sant Vicenç dels Horts,62,"4,4",42,"3,0",104,"3,7",Sant Vicenç dels Horts,Baix Llobregat,82634,28117
08,Barcelona,243,Santa Cecília de Voltregà,187,99,88,08243,Santa Cecília de Voltregà,0,"0,0",0,"0,0",0,"0,0",Santa Cecília de Voltregà,Osona,82439,187
08,Barcelona,244,Santa Coloma de Cervelló,8218,4026,4192,08244,Santa Coloma de Cervelló,26,"6,2",11,"2,7",37,"4,5",Santa Coloma de Cervelló,Baix Llobregat,82444,8218
08,Barcelona,245,Santa Coloma de Gramenet,119215,58895,60320,08245,Santa Coloma de Gramenet,395,"6,5",281,"4,8",676,"5,7",Santa Coloma de Gramenet,Barcelonès,82457,119215
08,Barcelona,246,Santa Eugènia de Berga,2248,1142,1106,08246,Santa Eugènia de Berga,6,"5,4",3,"2,6",9,"4,0",Santa Eugènia de Berga,Osona,82460,2248
08,Barcelona,247,Santa Eulàlia de Riuprimer,1345,686,659,08247,Santa Eulàlia de Riuprimer,8,"12,1",8,"11,7",16,"11,9",Santa Eulàlia de Riuprimer,Osona,82476,1345
08,Barcelona,248,Santa Eulàlia de Ronçana,7288,3639,3649,08248,Santa Eulàlia de Ronçana,9,"2,5",9,"2,5",18,"2,5",Santa Eulàlia de Ronçana,Vallès Oriental,82482,7288
08,Barcelona,249,Santa Fe del Penedès,374,185,189,08249,Santa Fe del Penedès,0,"0,0",0,"0,0",0,"0,0",Santa Fe del Penedès,Alt Penedès,82495,374
08,Barcelona,250,Santa Margarida de Montbui,9980,4993,4987,08250,Santa Margarida de Montbui,36,"7,2",43,"8,6",79,"7,9",Santa Margarida de Montbui,Anoia,82508,9980
08,Barcelona,251,Santa Margarida i els Monjos,7611,3856,3755,08251,Santa Margarida i els Monjos,5,"1,3",11,"2,9",16,"2,1",Santa Margarida i els Monjos,Alt Penedès,82515,7611
08,Barcelona,253,Santa Maria de Besora,150,78,72,08253,Santa Maria de Besora,0,"0,0",0,"0,0",0,"0,0",Santa Maria de Besora,Osona,82536,150
08,Barcelona,256,Santa Maria de Martorelles,893,449,444,08256,Santa Maria de Martorelles,0,"0,0",2,"4,5",2,"2,2",Santa Maria de Martorelles,Vallès Oriental,82567,893
08,Barcelona,255,Santa Maria de Merlès,184,89,95,08255,Santa Maria de Merlès,0,"0,0",0,"0,0",0,"0,0",Santa Maria de Merlès,Berguedà,82554,184
08,Barcelona,257,Santa Maria de Miralles,126,68,58,08257,Santa Maria de Miralles,0,"0,0",0,"0,0",0,"0,0",Santa Maria de Miralles,Anoia,82573,126
08,Barcelona,259,Santa Maria de Palautordera,9423,4760,4663,08259,Santa Maria de Palautordera,15,"3,2",8,"1,7",23,"2,4",Santa Maria de Palautordera,Vallès Oriental,82592,9423
08,Barcelona,258,Santa Maria d'Oló,1025,521,504,08258,Santa Maria d'Oló,1,"2,0",0,"0,0",1,"1,0",Santa Maria d'Oló,Moianès,82589,1025
08,Barcelona,260,Santa Perpètua de Mogoda,25799,12958,12841,08260,Santa Perpétua de Mogoda,47,"3,7",47,"3,6",94,"3,6",Santa Perpètua de Mogoda,Vallès Occidental,82606,25799
08,Barcelona,261,Santa Susanna,3446,1721,1725,08261,Santa Susanna,4,"2,3",4,"2,3",8,"2,3",Santa Susanna,Maresme,82613,3446
08,Barcelona,192,Santpedor,7554,3755,3799,08192,Santpedor,14,"3,7",8,"2,1",22,"2,9",Santpedor,Bages,81923,7554
08,Barcelona,267,Sentmenat,9078,4611,4467,08267,Sentmenat,12,"2,7",5,"1,1",17,"1,9",Sentmenat,Vallès Occidental,82671,9078
08,Barcelona,269,Seva,3519,1784,1735,08269,Seva,5,"2,9",2,"1,1",7,"2,0",Seva,Osona,82690,3519
08,Barcelona,270,Sitges,29307,14708,14599,08270,Sitges,28,"1,9",29,"2,0",57,"1,9",Sitges,Garraf,82704,29307
08,Barcelona,271,Sobremunt,79,36,43,08271,Sobremunt,0,"0,0",0,"0,0",0,"0,0",Sobremunt,Osona,82711,79
08,Barcelona,272,Sora,209,117,92,08272,Sora,0,"0,0",0,"0,0",0,"0,0",Sora,Osona,82726,209
08,Barcelona,273,Subirats,3044,1577,1467,08273,Subirats,5,"3,4",2,"1,3",7,"2,3",Subirats,Alt Penedès,82732,3044
08,Barcelona,274,Súria,5942,2897,3045,08274,Súria,9,"3,0",5,"1,7",14,"2,4",Súria,Bages,82747,5942
08,Barcelona,276,Tagamanent,323,169,154,08276,Tagamanent,0,"0,0",0,"0,0",0,"0,0",Tagamanent,Vallès Oriental,82763,323
08,Barcelona,277,Talamanca,206,115,91,08277,Talamanca,0,"0,0",0,"0,0",0,"0,0",Talamanca,Bages,82779,206
08,Barcelona,278,Taradell,6489,3238,3251,08278,Taradell,16,"4,9",16,"4,9",32,"4,9",Taradell,Osona,82785,6489
08,Barcelona,275,Tavèrnoles,316,159,157,08275,Tavèrnoles,0,"0,0",0,"0,0",0,"0,0",Tavèrnoles,Osona,82750,316
08,Barcelona,280,Tavertet,111,57,54,08280,Tavertet,0,"0,0",0,"0,0",0,"0,0",Tavertet,Osona,82802,111
08,Barcelona,281,Teià,6397,3134,3263,08281,Teià,4,"1,2",8,"2,6",12,"1,9",Teià,Maresme,82819,6397
08,Barcelona,279,Terrassa,220556,108469,112087,08279,Terrassa,519,"4,6",448,"4,1",967,"4,4",Terrassa,Vallès Occidental,82798,220556
08,Barcelona,282,Tiana,8840,4233,4607,08282,Tiana,20,"4,3",21,"5,0",41,"4,6",Tiana,Maresme,82824,8840
08,Barcelona,283,Tona,8241,4099,4142,08283,Tona,25,"6,0",15,"3,7",40,"4,9",Tona,Osona,82830,8241
08,Barcelona,284,Tordera,17216,8722,8494,08284,Tordera,15,"1,8",8,"0,9",23,"1,3",Tordera,Maresme,82845,17216
08,Barcelona,285,Torelló,14347,7137,7210,08285,Torelló,34,"4,7",26,"3,6",60,"4,2",Torelló,Osona,82858,14347
08,Barcelona,286,"Torre de Claramunt, La",3714,1923,1791,08286,La Torre de Claramunt,14,"7,8",14,"7,3",28,"7,5","Torre de Claramunt, la",Anoia,82861,3714
08,Barcelona,287,Torrelavit,1419,723,696,08287,Torrelavit,0,"0,0",4,"5,5",4,"2,8",Torrelavit,Alt Penedès,82877,1419
08,Barcelona,288,Torrelles de Foix,2348,1267,1081,08288,Torrelles de Foix,2,"1,9",3,"2,4",5,"2,1",Torrelles de Foix,Alt Penedès,82883,2348
08,Barcelona,289,Torrelles de Llobregat,6041,3003,3038,08289,Torrelles de Llobregat,3,"1,0",6,"2,0",9,"1,5",Torrelles de Llobregat,Baix Llobregat,82896,6041
08,Barcelona,290,Ullastrell,2093,1052,1041,08290,Ullastrell,11,"10,6",7,"6,7",18,"8,6",Ullastrell,Vallès Occidental,82900,2093
08,Barcelona,291,Vacarisses,6688,3436,3252,08291,Vacarisses,7,"2,2",6,"1,7",13,"1,9",Vacarisses,Vallès Occidental,82917,6688
08,Barcelona,292,Vallbona d'Anoia,1373,719,654,08292,Vallbona d'Anoia,3,"4,6",6,"8,3",9,"6,6",Vallbona d'Anoia,Anoia,82922,1373
08,Barcelona,293,Vallcebre,250,142,108,08293,Vallcebre,0,"0,0",0,"0,0",0,"0,0",Vallcebre,Berguedà,82938,250
08,Barcelona,294,Vallgorguina,2891,1451,1440,08294,Vallgorguina,2,"1,4",3,"2,1",5,"1,7",Vallgorguina,Vallès Oriental,82943,2891
08,Barcelona,295,Vallirana,15006,7523,7483,08295,Vallirana,20,"2,7",21,"2,8",41,"2,7",Vallirana,Baix Llobregat,82956,15006
08,Barcelona,296,Vallromanes,2579,1328,1251,08296,Vallromanes,2,"1,6",3,"2,3",5,"1,9",Vallromanes,Vallès Oriental,82969,2579
08,Barcelona,297,Veciana,182,99,83,08297,Veciana,0,"0,0",0,"0,0",0,"0,0",Veciana,Anoia,82975,182
08,Barcelona,298,Vic,46214,23306,22908,08298,Vic,135,"5,9",107,"4,6",242,"5,2",Vic,Osona,82981,46214
08,Barcelona,299,Vilada,416,217,199,08299,Vilada,0,"0,0",0,"0,0",0,"0,0",Vilada,Berguedà,82994,416
08,Barcelona,301,Viladecans,66611,32930,33681,08301,Viladecans,241,"7,2",198,"6,0",439,"6,6",Viladecans,Baix Llobregat,83015,66611
08,Barcelona,300,Viladecavalls,7512,3724,3788,08300,Viladecavalls,19,"5,0",13,"3,5",32,"4,3",Viladecavalls,Vallès Occidental,83008,7512
08,Barcelona,305,Vilafranca del Penedès,39746,19341,20405,08305,Vilafranca del Penedès,96,"4,7",38,"2,0",134,"3,4",Vilafranca del Penedès,Alt Penedès,83054,39746
08,Barcelona,306,Vilalba Sasserra,716,357,359,08306,Vilalba Sasserra,15,"41,8",11,"30,8",26,"36,3",Vilalba Sasserra,Vallès Oriental,83067,716
08,Barcelona,303,Vilanova de Sau,299,142,157,08303,Vilanova de Sau,1,"6,4",0,"0,0",1,"3,3",Vilanova de Sau,Osona,83036,299
08,Barcelona,302,Vilanova del Camí,12458,6227,6231,08302,Vilanova del Camí,49,"7,9",39,"6,3",88,"7,1",Vilanova del Camí,Anoia,83020,12458
08,Barcelona,902,Vilanova del Vallès,5432,2760,2672,08902,Vilanova del Vallès,11,"4,1",6,"2,2",17,"3,1",Vilanova del Vallès,Vallès Oriental,89024,5432
08,Barcelona,307,Vilanova i la Geltrú,67086,32456,34630,08307,Vilanova i la Geltrú,83,"2,4",86,"2,6",169,"2,5",Vilanova i la Geltrú,Garraf,83073,67086
08,Barcelona,214,Vilassar de Dalt,9043,4462,4581,08214,Vilassar de Dalt,11,"2,4",9,"2,0",20,"2,2",Vilassar de Dalt,Maresme,82140,9043
08,Barcelona,219,Vilassar de Mar,20837,10068,10769,08219,Vilassar de Mar,32,"3,0",28,"2,8",60,"2,9",Vilassar de Mar,Maresme,82191,20837
08,Barcelona,304,Vilobí del Penedès,1107,569,538,08304,Vilobí del Penedès,2,"3,7",0,"0,0",2,"1,8",Vilobí del Penedès,Alt Penedès,83041,1107
08,Barcelona,308,Viver i Serrateix,168,87,81,08308,Viver i Serrateix,0,"0,0",0,"0,0",0,"0,0",Viver i Serrateix,Berguedà,83089,168
17,Girona,001,Agullana,831,411,420,17001,Agullana,0,"0,0",2,"4,9",2,"2,4",Agullana,Alt Empordà,170010,831
17,Girona,002,Aiguaviva,756,383,373,17002,Aiguaviva,2,"5,4",2,"5,2",4,"5,3",Aiguaviva,Gironès,170025,756
17,Girona,003,Albanyà,157,80,77,17003,Albanyà,0,"0,0",0,"0,0",0,"0,0",Albanyà,Alt Empordà,170031,157
17,Girona,004,Albons,776,401,375,17004,Albons,1,"2,7",0,"0,0",1,"1,3",Albons,Baix Empordà,170046,776
17,Girona,006,Alp,1580,828,752,17006,Alp,0,"0,0",3,"3,6",3,"1,9",Alp,Cerdanya,170062,1580
17,Girona,007,Amer,2298,1122,1176,17007,Amer,1,"0,9",3,"2,7",4,"1,7",Amer,Selva,170078,2298
17,Girona,008,Anglès,5599,2780,2819,17008,Anglès,5,"1,8",6,"2,2",11,"2,0",Anglès,Selva,170084,5599
17,Girona,009,Arbúcies,6556,3390,3166,17009,Arbúcies,8,"2,5",3,"0,9",11,"1,7",Arbúcies,Selva,170097,6556
17,Girona,010,Argelaguer,397,205,192,17010,Argelaguer,0,"0,0",0,"0,0",0,"0,0",Argelaguer,Garrotxa,170101,397
17,Girona,011,"Armentera, L'",930,461,469,17011,L'Armentera,3,"6,4",2,"4,3",5,"5,4","Armentera, l'",Alt Empordà,170118,930
17,Girona,012,Avinyonet de Puigventós,1610,796,814,17012,Avinyonet de Puigventós,1,"1,2",1,"1,3",2,"1,2",Avinyonet de Puigventós,Alt Empordà,170123,1610
17,Girona,015,Banyoles,19826,9873,9953,17015,Banyoles,32,"3,2",32,"3,2",64,"3,2",Banyoles,Pla de l'Estany,170157,19826
17,Girona,016,Bàscara,1004,520,484,17016,Bàscara,0,"0,0",0,"0,0",0,"0,0",Bàscara,Alt Empordà,170160,1004
17,Girona,013,Begur,3925,1964,1961,17013,Begur,1,"0,5",0,"0,0",1,"0,3",Begur,Baix Empordà,170139,3925
17,Girona,018,Bellcaire d'Empordà,693,336,357,17018,Bellcaire d'Empordà,0,"0,0",1,"3,0",1,"1,4",Bellcaire d'Empordà,Baix Empordà,170182,693
17,Girona,019,Besalú,2492,1170,1322,17019,Besalú,2,"1,5",4,"3,4",6,"2,4",Besalú,Garrotxa,170195,2492
17,Girona,020,Bescanó,4960,2505,2455,17020,Bescanó,12,"4,9",8,"3,2",20,"4,0",Bescanó,Gironès,170209,4960
17,Girona,021,Beuda,190,100,90,17021,Beuda,0,"0,0",0,"0,0",0,"0,0",Beuda,Garrotxa,170216,190
17,Girona,022,"Bisbal d'Empordà, La",10974,5446,5528,17022,La Bisbal d'Empordà,5,"0,9",3,"0,6",8,"0,7","Bisbal d'Empordà, la",Baix Empordà,170221,10974
17,Girona,234,Biure,232,118,114,17234,Biure,0,"0,0",0,"0,0",0,"0,0",Biure,Alt Empordà,172348,232
17,Girona,023,Blanes,39028,19356,19672,17023,Blanes,44,"2,2",47,"2,4",91,"2,3",Blanes,Selva,170237,39028
17,Girona,029,Boadella i les Escaules,252,130,122,17029,Boadella i les Escaules,0,"0,0",0,"0,0",0,"0,0",Boadella i les Escaules,Alt Empordà,170293,252
17,Girona,024,Bolvir,369,191,178,17024,Bolvir,0,"0,0",0,"0,0",0,"0,0",Bolvir,Cerdanya,170242,369
17,Girona,025,Bordils,1779,887,892,17025,Bordils,0,"0,0",4,"4,5",4,"2,2",Bordils,Gironès,170255,1779
17,Girona,026,Borrassà,714,374,340,17026,Borrassà,3,"8,8",0,"0,0",3,"4,2",Borrassà,Alt Empordà,170268,714
17,Girona,027,Breda,3740,1836,1904,17027,Breda,2,"1,1",4,"2,2",6,"1,6",Breda,Selva,170274,3740
17,Girona,028,Brunyola i Sant Martí Sapresa,383,195,188,17028,Brunyola,1,"5,3",0,"0,0",1,"2,6",Brunyola i Sant Martí Sapresa,Selva,170280,383
17,Girona,031,Cabanelles,279,154,125,17031,Cabanelles,0,"0,0",0,"0,0",0,"0,0",Cabanelles,Alt Empordà,170314,279
17,Girona,030,Cabanes,948,500,448,17030,Cabanes,0,"0,0",0,"0,0",0,"0,0",Cabanes,Alt Empordà,170307,948
17,Girona,032,Cadaqués,2712,1322,1390,17032,Cadaqués,2,"1,4",3,"2,3",5,"1,8",Cadaqués,Alt Empordà,170329,2712
17,Girona,033,Caldes de Malavella,7641,3828,3813,17033,Caldes de Malavella,11,"2,9",10,"2,6",21,"2,7",Caldes de Malavella,Selva,170335,7641
17,Girona,034,Calonge i Sant Antoni,11092,5571,5521,17034,Calonge i Sant Antoni,8,"1,4",5,"0,9",13,"1,2",Calonge i Sant Antoni,Baix Empordà,170340,11092
17,Girona,035,Camós,693,341,352,17035,Camós,2,"5,7",0,"0,0",2,"2,9",Camós,Pla de l'Estany,170353,693
17,Girona,036,Campdevànol,3223,1566,1657,17036,Campdevànol,4,"2,4",2,"1,3",6,"1,9",Campdevànol,Ripollès,170366,3223
17,Girona,037,Campelles,139,71,68,17037,Campelles,0,"0,0",0,"0,0",0,"0,0",Campelles,Ripollès,170372,139
17,Girona,038,Campllong,547,272,275,17038,Campllong,0,"0,0",1,"3,7",1,"1,8",Campllong,Gironès,170388,547
17,Girona,039,Camprodon,2281,1117,1164,17039,Camprodon,0,"0,0",1,"0,9",1,"0,4",Camprodon,Ripollès,170391,2281
17,Girona,040,Canet d'Adri,723,371,352,17040,Canet d'Adri,1,"2,8",1,"2,7",2,"2,8",Canet d'Adri,Gironès,170405,723
17,Girona,041,Cantallops,313,153,160,17041,Cantallops,0,"0,0",0,"0,0",0,"0,0",Cantallops,Alt Empordà,170412,313
17,Girona,042,Capmany,613,307,306,17042,Capmany,3,"9,8",4,"13,0",7,"11,4",Capmany,Alt Empordà,170427,613
17,Girona,044,Cassà de la Selva,10380,5301,5079,17044,Cassà de la Selva,17,"3,3",12,"2,3",29,"2,8",Cassà de la Selva,Gironès,170448,10380
17,Girona,046,Castellfollit de la Roca,961,493,468,17046,Castellfollit de la Roca,2,"4,3",0,"0,0",2,"2,1",Castellfollit de la Roca,Garrotxa,170464,961
17,Girona,047,Castelló d'Empúries,10906,5508,5398,17047,Castelló d'Empúries,8,"1,5",3,"0,5",11,"1,0",Castelló d'Empúries,Alt Empordà,170470,10906
17,Girona,048,Castell-Platja d'Aro,10860,5357,5503,17048,Castell-Platja d'Aro,5,"0,9",5,"0,9",10,"0,9",Castell-Platja d'Aro,Baix Empordà,170486,10860
17,Girona,189,"Cellera de Ter, La",1946,965,981,17189,La Cellera de Ter,2,"2,0",1,"1,0",3,"1,5","Cellera de Ter, la",Selva,171899,1946
17,Girona,049,Celrà,5452,2722,2730,17049,Celrà,5,"1,8",7,"2,6",12,"2,2",Celrà,Gironès,170499,5452
17,Girona,050,Cervià de Ter,968,492,476,17050,Cervià de Ter,2,"4,2",2,"4,1",4,"4,1",Cervià de Ter,Gironès,170502,968
17,Girona,051,Cistella,282,138,144,17051,Cistella,0,"0,0",1,"7,2",1,"3,5",Cistella,Alt Empordà,170519,282
17,Girona,054,Colera,448,223,225,17054,Colera,1,"4,4",0,"0,0",1,"2,2",Colera,Alt Empordà,170545,448
17,Girona,055,Colomers,176,87,89,17055,Colomers,0,"0,0",0,"0,0",0,"0,0",Colomers,Baix Empordà,170558,176
17,Girona,057,Corçà,1267,646,621,17057,Corçà,0,"0,0",1,"1,5",1,"0,8",Corçà,Baix Empordà,170577,1267
17,Girona,056,Cornellà del Terri,2364,1197,1167,17056,Cornellà del Terri,2,"1,7",3,"2,5",5,"2,1",Cornellà del Terri,Pla de l'Estany,170561,2364
17,Girona,058,Crespià,246,127,119,17058,Crespià,0,"0,0",1,"7,9",1,"4,1",Crespià,Pla de l'Estany,170583,246
17,Girona,901,"Cruïlles, Monells i Sant Sadurní de l'Heura",1279,640,639,17901,Cruïlles Monells i Sant Sadurní de l'Heura,0,"0,0",1,"1,6",1,"0,8","Cruïlles, Monells i Sant Sadurní de l'Heura",Baix Empordà,179011,1279
17,Girona,060,Darnius,546,273,273,17060,Darnius,0,"0,0",0,"0,0",0,"0,0",Darnius,Alt Empordà,170600,546
17,Girona,061,Das,253,131,122,17061,Das,0,"0,0",0,"0,0",0,"0,0",Das,Cerdanya,170617,253
17,Girona,062,"Escala, L'",10339,5267,5072,17062,L'Escala,5,"1,0",5,"0,9",10,"1,0","Escala, l'",Alt Empordà,170622,10339
17,Girona,063,Espinelves,215,110,105,17063,Espinelves,0,"0,0",0,"0,0",0,"0,0",Espinelves,Osona,170638,215
17,Girona,064,Espolla,416,203,213,17064,Espolla,0,"0,0",0,"0,0",0,"0,0",Espolla,Alt Empordà,170643,416
17,Girona,065,Esponellà,438,224,214,17065,Esponellà,0,"0,0",1,"4,5",1,"2,3",Esponellà,Pla de l'Estany,170656,438
17,Girona,005,"Far d'Empordà, El",599,305,294,17005,El Far d'Empordà,1,"3,4",2,"6,6",3,"5,0","Far d'Empordà, el",Alt Empordà,170059,599
17,Girona,066,Figueres,46654,23092,23562,17066,Figueres,49,"2,1",29,"1,3",78,"1,7",Figueres,Alt Empordà,170669,46654
17,Girona,067,Flaçà,1093,528,565,17067,Flaçà,2,"3,5",0,"0,0",2,"1,8",Flaçà,Gironès,170675,1093
17,Girona,068,Foixà,297,150,147,17068,Foixà,0,"0,0",0,"0,0",0,"0,0",Foixà,Baix Empordà,170681,297
17,Girona,069,Fontanals de Cerdanya,444,220,224,17069,Fontanals de Cerdanya,0,"0,0",1,"4,5",1,"2,3",Fontanals de Cerdanya,Cerdanya,170694,444
17,Girona,070,Fontanilles,139,80,59,17070,Fontanilles,0,"0,0",0,"0,0",0,"0,0",Fontanilles,Baix Empordà,170708,139
17,Girona,071,Fontcoberta,1468,738,730,17071,Fontcoberta,1,"1,4",2,"2,7",3,"2,0",Fontcoberta,Pla de l'Estany,170715,1468
17,Girona,902,Forallac,1687,828,859,17902,Forallac,0,"0,0",0,"0,0",0,"0,0",Forallac,Baix Empordà,179026,1687
17,Girona,073,Fornells de la Selva,2650,1322,1328,17073,Fornells de la Selva,5,"3,8",6,"4,5",11,"4,2",Fornells de la Selva,Gironès,170736,2650
17,Girona,074,Fortià,763,389,374,17074,Fortià,0,"0,0",0,"0,0",0,"0,0",Fortià,Alt Empordà,170741,763
17,Girona,075,Garrigàs,437,231,206,17075,Garrigàs,0,"0,0",0,"0,0",0,"0,0",Garrigàs,Alt Empordà,170754,437
17,Girona,076,Garrigoles,162,84,78,17076,Garrigoles,0,"0,0",0,"0,0",0,"0,0",Garrigoles,Baix Empordà,170767,162
17,Girona,077,Garriguella,855,421,434,17077,Garriguella,1,"2,3",0,"0,0",1,"1,2",Garriguella,Alt Empordà,170773,855
17,Girona,078,Ger,448,222,226,17078,Ger,1,"4,4",0,"0,0",1,"2,2",Ger,Cerdanya,170789,448
17,Girona,079,Girona,101852,48931,52921,17079,Girona,255,"4,8",169,"3,5",424,"4,2",Girona,Gironès,170792,101852
17,Girona,080,Gombrèn,188,96,92,17080,Gombrèn,0,"0,0",1,"10,4",1,"5,3",Gombrèn,Ripollès,170806,188
17,Girona,081,Gualta,397,229,168,17081,Gualta,0,"0,0",0,"0,0",0,"0,0",Gualta,Baix Empordà,170813,397
17,Girona,082,Guils de Cerdanya,537,288,249,17082,Guils de Cerdanya,0,"0,0",0,"0,0",0,"0,0",Guils de Cerdanya,Cerdanya,170828,537
17,Girona,083,Hostalric,4221,2130,2091,17083,Hostalric,7,"3,3",6,"2,8",13,"3,1",Hostalric,Selva,170834,4221
17,Girona,084,Isòvol,281,161,120,17084,Isòvol,0,"0,0",0,"0,0",0,"0,0",Isòvol,Cerdanya,170849,281
17,Girona,085,Jafre,380,206,174,17085,Jafre,0,"0,0",0,"0,0",0,"0,0",Jafre,Baix Empordà,170852,380
17,Girona,086,"Jonquera, La",3290,1637,1653,17086,La Jonquera,1,"0,6",3,"1,8",4,"1,2","Jonquera, la",Alt Empordà,170865,3290
17,Girona,087,Juià,323,174,149,17087,Juià,0,"0,0",0,"0,0",0,"0,0",Juià,Gironès,170871,323
17,Girona,088,Lladó,818,398,420,17088,Lladó,1,"2,4",1,"2,5",2,"2,4",Lladó,Alt Empordà,170887,818
17,Girona,089,Llagostera,8453,4303,4150,17089,Llagostera,11,"2,7",9,"2,1",20,"2,4",Llagostera,Gironès,170890,8453
17,Girona,090,Llambilles,696,359,337,17090,Llambilles,1,"3,0",1,"2,8",2,"2,9",Llambilles,Gironès,170904,696
17,Girona,091,Llanars,505,259,246,17091,Llanars,0,"0,0",0,"0,0",0,"0,0",Llanars,Ripollès,170911,505
17,Girona,092,Llançà,4836,2394,2442,17092,Llançà,1,"0,4",3,"1,3",4,"0,8",Llançà,Alt Empordà,170926,4836
17,Girona,093,Llers,1239,617,622,17093,Llers,2,"3,2",0,"0,0",2,"1,6",Llers,Alt Empordà,170932,1239
17,Girona,094,Llívia,1417,748,669,17094,Llívia,0,"0,0",1,"1,3",1,"0,7",Llívia,Cerdanya,170947,1417
17,Girona,095,Lloret de Mar,38373,19528,18845,17095,Lloret de Mar,69,"3,7",47,"2,4",116,"3,0",Lloret de Mar,Selva,170950,38373
17,Girona,096,"Llosses, Les",218,121,97,17096,"Llosses, Les",0,"0,0",0,"0,0",0,"0,0","Llosses, les",Ripollès,170963,218
17,Girona,102,Maçanet de Cabrenys,688,340,348,17102,Maçanet de Cabrenys,1,"2,9",0,"0,0",1,"1,5",Maçanet de Cabrenys,Alt Empordà,171024,688
17,Girona,103,Maçanet de la Selva,7006,3598,3408,17103,Maçanet de la Selva,3,"0,9",2,"0,6",5,"0,7",Maçanet de la Selva,Selva,171030,7006
17,Girona,097,Madremanya,283,138,145,17097,Madremanya,0,"0,0",0,"0,0",0,"0,0",Madremanya,Gironès,170979,283
17,Girona,098,Maià de Montcal,449,251,198,17098,Maià de Montcal,1,"5,1",1,"4,0",2,"4,5",Maià de Montcal,Garrotxa,170985,449
17,Girona,100,Masarac,288,150,138,17100,Masarac,2,"14,5",0,"0,0",2,"6,9",Masarac,Alt Empordà,171002,288
17,Girona,101,Massanes,761,405,356,17101,Massanes,2,"5,6",3,"7,4",5,"6,6",Massanes,Selva,171019,761
17,Girona,099,Meranges,104,58,46,17099,Meranges,0,"0,0",0,"0,0",0,"0,0",Meranges,Cerdanya,170998,104
17,Girona,105,Mieres,318,160,158,17105,Mieres,0,"0,0",0,"0,0",0,"0,0",Mieres,Garrotxa,171058,318
17,Girona,106,Mollet de Peralada,189,96,93,17106,Mollet de Peralada,0,"0,0",0,"0,0",0,"0,0",Mollet de Peralada,Alt Empordà,171061,189
17,Girona,107,Molló,337,162,175,17107,Molló,0,"0,0",0,"0,0",0,"0,0",Molló,Ripollès,171077,337
17,Girona,109,Montagut i Oix,916,475,441,17109,Montagut i Oix,0,"0,0",2,"4,2",2,"2,2",Montagut i Oix,Garrotxa,171096,916
17,Girona,110,Mont-ras,1679,846,833,17110,Mont-Ras,3,"3,6",1,"1,2",4,"2,4",Mont-ras,Baix Empordà,171100,1679
17,Girona,111,Navata,1381,671,710,17111,Navata,0,"0,0",2,"3,0",2,"1,4",Navata,Alt Empordà,171117,1381
17,Girona,112,Ogassa,234,130,104,17112,Ogassa,0,"0,0",0,"0,0",0,"0,0",Ogassa,Ripollès,171122,234
17,Girona,114,Olot,35228,17569,17659,17114,Olot,102,"5,8",59,"3,4",161,"4,6",Olot,Garrotxa,171143,35228
17,Girona,115,Ordis,371,199,172,17115,Ordis,0,"0,0",1,"5,0",1,"2,7",Ordis,Alt Empordà,171156,371
17,Girona,116,Osor,428,227,201,17116,Osor,0,"0,0",0,"0,0",0,"0,0",Osor,Selva,171169,428
17,Girona,117,Palafrugell,22974,11377,11597,17117,Palafrugell,62,"5,3",30,"2,6",92,"4,0",Palafrugell,Baix Empordà,171175,22974
17,Girona,118,Palamós,17910,8766,9144,17118,Palamós,28,"3,1",23,"2,6",51,"2,8",Palamós,Baix Empordà,171181,17910
17,Girona,119,Palau de Santa Eulàlia,91,52,39,17119,Palau de Santa Eulàlia,0,"0,0",0,"0,0",0,"0,0",Palau de Santa Eulàlia,Alt Empordà,171194,91
17,Girona,121,Palau-sator,310,166,144,17121,Palau-Sator,1,"6,9",1,"6,0",2,"6,5",Palau-sator,Baix Empordà,171215,310
17,Girona,120,Palau-saverdera,1476,741,735,17120,Palau-Saverdera,1,"1,4",2,"2,7",3,"2,0",Palau-saverdera,Alt Empordà,171208,1476
17,Girona,123,Palol de Revardit,455,228,227,17123,Palol de Revardit,1,"4,4",0,"0,0",1,"2,2",Palol de Revardit,Pla de l'Estany,171236,455
17,Girona,124,Pals,2411,1222,1189,17124,Pals,1,"0,8",1,"0,8",2,"0,8",Pals,Baix Empordà,171241,2411
17,Girona,125,Pardines,162,89,73,17125,Pardines,0,"0,0",0,"0,0",0,"0,0",Pardines,Ripollès,171254,162
17,Girona,126,Parlavà,394,199,195,17126,Parlavà,0,"0,0",1,"5,0",1,"2,5",Parlavà,Baix Empordà,171267,394
17,Girona,128,Pau,560,285,275,17128,Pau,0,"0,0",0,"0,0",0,"0,0",Pau,Alt Empordà,171289,560
17,Girona,129,Pedret i Marzà,198,101,97,17129,Pedret i Marzà,0,"0,0",0,"0,0",0,"0,0",Pedret i Marzà,Alt Empordà,171292,198
17,Girona,130,"Pera, La",446,221,225,17130,"Pera, La",0,"0,0",0,"0,0",0,"0,0","Pera, la",Baix Empordà,171306,446
17,Girona,132,Peralada,1850,906,944,17132,Peralada,0,"0,0",1,"1,1",1,"0,5",Peralada,Alt Empordà,171328,1850
17,Girona,133,"Planes d'Hostoles, Les",1683,851,832,17133,Les Planes d'Hostoles,2,"2,4",5,"5,9",7,"4,2","Planes d'Hostoles, les",Garrotxa,171334,1683
17,Girona,134,Planoles,288,157,131,17134,Planoles,0,"0,0",0,"0,0",0,"0,0",Planoles,Ripollès,171349,288
17,Girona,135,Pont de Molins,529,267,262,17135,Pont de Molins,0,"0,0",0,"0,0",0,"0,0",Pont de Molins,Alt Empordà,171352,529
17,Girona,136,Pontós,266,141,125,17136,Pontós,0,"0,0",0,"0,0",0,"0,0",Pontós,Alt Empordà,171365,266
17,Girona,137,Porqueres,4621,2288,2333,17137,Porqueres,5,"2,1",5,"2,2",10,"2,2",Porqueres,Pla de l'Estany,171371,4621
17,Girona,140,"Port de la Selva, El",970,501,469,17140,El Port de la Selva,0,"0,0",1,"2,0",1,"1,0","Port de la Selva, el",Alt Empordà,171404,970
17,Girona,138,Portbou,1075,528,547,17138,Portbou,1,"1,8",0,"0,0",1,"0,9",Portbou,Alt Empordà,171387,1075
17,Girona,139,"Preses, Les",1788,890,898,17139,Les Preses,7,"7,8",4,"4,5",11,"6,2","Preses, les",Garrotxa,171390,1788
17,Girona,141,Puigcerdà,9258,4585,4673,17141,Puigcerdà,13,"2,8",7,"1,5",20,"2,2",Puigcerdà,Cerdanya,171411,9258
17,Girona,142,Quart,3724,1855,1869,17142,Quart,4,"2,1",2,"1,1",6,"1,6",Quart,Gironès,171426,3724
17,Girona,043,Queralbs,191,104,87,17043,Queralbs,0,"0,0",0,"0,0",0,"0,0",Queralbs,Ripollès,170433,191
17,Girona,143,Rabós,178,89,89,17143,Rabós,0,"0,0",0,"0,0",0,"0,0",Rabós,Alt Empordà,171432,178
17,Girona,144,Regencós,269,141,128,17144,Regencós,0,"0,0",1,"7,1",1,"3,7",Regencós,Baix Empordà,171447,269
17,Girona,145,Ribes de Freser,1754,882,872,17145,Ribes de Freser,2,"2,3",1,"1,1",3,"1,7",Ribes de Freser,Ripollès,171450,1754
17,Girona,146,Riells i Viabrea,4124,2113,2011,17146,Riells i Viabrea,4,"2,0",4,"1,9",8,"1,9",Riells i Viabrea,Selva,171463,4124
17,Girona,147,Ripoll,10686,5273,5413,17147,Ripoll,17,"3,1",20,"3,8",37,"3,5",Ripoll,Ripollès,171479,10686
17,Girona,148,Riudarenes,2182,1125,1057,17148,Riudarenes,2,"1,9",4,"3,6",6,"2,7",Riudarenes,Selva,171485,2182
17,Girona,149,Riudaura,478,232,246,17149,Riudaura,2,"8,1",0,"0,0",2,"4,2",Riudaura,Garrotxa,171498,478
17,Girona,150,Riudellots de la Selva,2076,1053,1023,17150,Riudellots de la Selva,1,"1,0",0,"0,0",1,"0,5",Riudellots de la Selva,Selva,171501,2076
17,Girona,151,Riumors,258,126,132,17151,Riumors,0,"0,0",0,"0,0",0,"0,0",Riumors,Alt Empordà,171518,258
17,Girona,152,Roses,19550,9862,9688,17152,Roses,9,"0,9",7,"0,7",16,"0,8",Roses,Alt Empordà,171523,19550
17,Girona,153,Rupià,272,138,134,17153,Rupià,0,"0,0",1,"7,2",1,"3,7",Rupià,Baix Empordà,171539,272
17,Girona,154,Sales de Llierca,154,77,77,17154,Sales de Llierca,0,"0,0",0,"0,0",0,"0,0",Sales de Llierca,Garrotxa,171544,154
17,Girona,155,Salt,31362,16454,14908,17155,Salt,54,"3,6",56,"3,4",110,"3,5",Salt,Gironès,171557,31362
17,Girona,157,Sant Andreu Salou,155,79,76,17157,Sant Andreu Salou,0,"0,0",0,"0,0",0,"0,0",Sant Andreu Salou,Gironès,171576,155
17,Girona,183,Sant Aniol de Finestres,341,177,164,17183,Sant Aniol de Finestres,0,"0,0",0,"0,0",0,"0,0",Sant Aniol de Finestres,Garrotxa,171833,341
17,Girona,158,Sant Climent Sescebes,626,364,262,17158,Sant Climent Sescebes,1,"3,8",2,"5,5",3,"4,8",Sant Climent Sescebes,Alt Empordà,171582,626
17,Girona,159,Sant Feliu de Buixalleu,783,410,373,17159,Sant Feliu de Buixalleu,1,"2,7",2,"4,9",3,"3,8",Sant Feliu de Buixalleu,Selva,171595,783
17,Girona,160,Sant Feliu de Guíxols,21925,10802,11123,17160,Sant Feliu de Guíxols,11,"1,0",21,"1,9",32,"1,5",Sant Feliu de Guíxols,Baix Empordà,171609,21925
17,Girona,161,Sant Feliu de Pallerols,1371,667,704,17161,Sant Feliu de Pallerols,1,"1,4",1,"1,5",2,"1,5",Sant Feliu de Pallerols,Garrotxa,171616,1371
17,Girona,162,Sant Ferriol,243,124,119,17162,Sant Ferriol,1,"8,4",0,"0,0",1,"4,1",Sant Ferriol,Garrotxa,171621,243
17,Girona,163,Sant Gregori,3817,1959,1858,17163,Sant Gregori,13,"7,0",9,"4,6",22,"5,8",Sant Gregori,Gironès,171637,3817
17,Girona,164,Sant Hilari Sacalm,5627,2843,2784,17164,Sant Hilari Sacalm,29,"10,4",14,"4,9",43,"7,6",Sant Hilari Sacalm,Selva,171642,5627
17,Girona,165,Sant Jaume de Llierca,865,416,449,17165,Sant Jaume de Llierca,4,"8,9",1,"2,4",5,"5,8",Sant Jaume de Llierca,Garrotxa,171655,865
17,Girona,167,Sant Joan de les Abadesses,3232,1604,1628,17167,Sant Joan de les Abadesses,7,"4,3",5,"3,1",12,"3,7",Sant Joan de les Abadesses,Ripollès,171674,3232
17,Girona,168,Sant Joan de Mollet,507,248,259,17168,Sant Joan de Mollet,1,"3,9",0,"0,0",1,"2,0",Sant Joan de Mollet,Gironès,171680,507
17,Girona,185,Sant Joan les Fonts,3006,1541,1465,17185,Sant Joan Les Fonts,8,"5,5",5,"3,2",13,"4,3",Sant Joan les Fonts,Garrotxa,171851,3006
17,Girona,166,Sant Jordi Desvalls,761,380,381,17166,Sant Jordi Desvalls,2,"5,2",1,"2,6",3,"3,9",Sant Jordi Desvalls,Gironès,171668,761
17,Girona,169,Sant Julià de Ramis,3515,1780,1735,17169,Sant Julià de Ramis,9,"5,2",4,"2,2",13,"3,7",Sant Julià de Ramis,Gironès,171693,3515
17,Girona,903,Sant Julià del Llor i Bonmatí,1286,651,635,17903,Sant Julià del Llor i Bonmatí,1,"1,6",1,"1,5",2,"1,6",Sant Julià del Llor i Bonmatí,Selva,179032,1286
17,Girona,171,Sant Llorenç de la Muga,264,135,129,17171,Sant Llorenç de la Muga,0,"0,0",0,"0,0",0,"0,0",Sant Llorenç de la Muga,Alt Empordà,171714,264
17,Girona,172,Sant Martí de Llémena,633,330,303,17172,Sant Martí de Llémena,0,"0,0",0,"0,0",0,"0,0",Sant Martí de Llémena,Gironès,171729,633
17,Girona,173,Sant Martí Vell,252,131,121,17173,Sant Martí Vell,0,"0,0",0,"0,0",0,"0,0",Sant Martí Vell,Gironès,171735,252
17,Girona,174,Sant Miquel de Campmajor,231,127,104,17174,Sant Miquel de Campmajor,0,"0,0",0,"0,0",0,"0,0",Sant Miquel de Campmajor,Pla de l'Estany,171740,231
17,Girona,175,Sant Miquel de Fluvià,764,397,367,17175,Sant Miquel de Fluvià,2,"5,4",1,"2,5",3,"3,9",Sant Miquel de Fluvià,Alt Empordà,171753,764
17,Girona,176,Sant Mori,177,90,87,17176,Sant Mori,0,"0,0",0,"0,0",0,"0,0",Sant Mori,Alt Empordà,171766,177
17,Girona,177,Sant Pau de Segúries,697,347,350,17177,Sant Pau de Segúries,1,"2,9",0,"0,0",1,"1,4",Sant Pau de Segúries,Ripollès,171772,697
17,Girona,178,Sant Pere Pescador,2042,1084,958,17178,Sant Pere Pescador,2,"2,1",1,"0,9",3,"1,5",Sant Pere Pescador,Alt Empordà,171788,2042
17,Girona,180,Santa Coloma de Farners,13143,6621,6522,17180,Santa Coloma de Farners,23,"3,5",17,"2,6",40,"3,0",Santa Coloma de Farners,Selva,171805,13143
17,Girona,181,Santa Cristina d'Aro,5223,2624,2599,17181,Santa Cristina d'Aro,3,"1,2",3,"1,1",6,"1,1",Santa Cristina d'Aro,Baix Empordà,171812,5223
17,Girona,182,Santa Llogaia d'Àlguema,370,189,181,17182,Santa Llogaia d'Àlguema,0,"0,0",0,"0,0",0,"0,0",Santa Llogaia d'Àlguema,Alt Empordà,171827,370
17,Girona,184,Santa Pau,1565,792,773,17184,Santa Pau,1,"1,3",1,"1,3",2,"1,3",Santa Pau,Garrotxa,171848,1565
17,Girona,186,Sarrià de Ter,5170,2530,2640,17186,Sarrià de Ter,10,"3,8",12,"4,7",22,"4,3",Sarrià de Ter,Gironès,171864,5170
17,Girona,187,"Saus, Camallera i Llampaies",837,424,413,17187,Saus Camallera i Llampaies,1,"2,4",2,"4,7",3,"3,6","Saus, Camallera i Llampaies",Alt Empordà,171870,837
17,Girona,188,"Selva de Mar, La",196,108,88,17188,La Selva de Mar,0,"0,0",0,"0,0",0,"0,0","Selva de Mar, la",Alt Empordà,171886,196
17,Girona,190,Serinyà,1136,576,560,17190,Serinyà,0,"0,0",3,"5,2",3,"2,6",Serinyà,Pla de l'Estany,171903,1136
17,Girona,191,Serra de Daró,221,122,99,17191,Serra de Daró,0,"0,0",0,"0,0",0,"0,0",Serra de Daró,Baix Empordà,171910,221
17,Girona,192,Setcases,177,98,79,17192,Setcases,0,"0,0",0,"0,0",0,"0,0",Setcases,Ripollès,171925,177
17,Girona,193,Sils,6093,3108,2985,17193,Sils,9,"3,0",11,"3,5",20,"3,3",Sils,Selva,171931,6093
17,Girona,052,Siurana,168,84,84,17052,Siurana,0,"0,0",0,"0,0",0,"0,0",Siurana,Alt Empordà,170524,168
17,Girona,194,Susqueda,101,60,41,17194,Susqueda,0,"0,0",0,"0,0",0,"0,0",Susqueda,Selva,171946,101
17,Girona,195,"Tallada d'Empordà, La",463,241,222,17195,La Tallada d'Empordà,0,"0,0",0,"0,0",0,"0,0","Tallada d'Empordà, la",Baix Empordà,171959,463
17,Girona,196,Terrades,329,162,167,17196,Terrades,3,"18,0",5,"30,9",8,"24,3",Terrades,Alt Empordà,171962,329
17,Girona,197,Torrent,175,92,83,17197,Torrent,0,"0,0",0,"0,0",0,"0,0",Torrent,Baix Empordà,171978,175
17,Girona,198,Torroella de Fluvià,694,354,340,17198,Torroella de Fluvià,0,"0,0",0,"0,0",0,"0,0",Torroella de Fluvià,Alt Empordà,171984,694
17,Girona,199,Torroella de Montgrí,11645,5900,5745,17199,Torroella de Montgrí,3,"0,5",3,"0,5",6,"0,5",Torroella de Montgrí,Baix Empordà,171997,11645
17,Girona,200,Tortellà,809,393,416,17200,Tortellà,2,"4,8",1,"2,5",3,"3,7",Tortellà,Garrotxa,172001,809
17,Girona,201,Toses,171,102,69,17201,Toses,0,"0,0",0,"0,0",0,"0,0",Toses,Ripollès,172018,171
17,Girona,202,Tossa de Mar,5683,2861,2822,17202,Tossa de Mar,0,"0,0",3,"1,0",3,"0,5",Tossa de Mar,Selva,172023,5683
17,Girona,204,Ullà,1153,632,521,17204,Ullà,0,"0,0",1,"1,6",1,"0,9",Ullà,Baix Empordà,172044,1153
17,Girona,205,Ullastret,290,140,150,17205,Ullastret,1,"6,7",0,"0,0",1,"3,4",Ullastret,Baix Empordà,172057,290
17,Girona,203,Ultramort,223,118,105,17203,Ultramort,0,"0,0",0,"0,0",0,"0,0",Ultramort,Baix Empordà,172039,223
17,Girona,206,Urús,189,93,96,17206,Urús,0,"0,0",0,"0,0",0,"0,0",Urús,Cerdanya,172060,189
17,Girona,014,"Vajol, La",89,48,41,17014,"Vajol, La",0,"0,0",0,"0,0",0,"0,0","Vajol, la",Alt Empordà,170144,89
17,Girona,208,"Vall de Bianya, La",1264,639,625,17208,La Vall de Bianya,3,"4,8",2,"3,1",5,"4,0","Vall de Bianya, la",Garrotxa,172082,1264
17,Girona,207,"Vall d'en Bas, La",3072,1553,1519,17207,La Vall d'En Bas,5,"3,3",2,"1,3",7,"2,3","Vall d'en Bas, la",Garrotxa,172076,3072
17,Girona,170,Vallfogona de Ripollès,206,109,97,17170,Vallfogona de Ripollès,0,"0,0",0,"0,0",0,"0,0",Vallfogona de Ripollès,Ripollès,171707,206
17,Girona,209,Vall-llobrega,899,446,453,17209,Vall-Llobrega,1,"2,2",1,"2,2",2,"2,2",Vall-llobrega,Baix Empordà,172095,899
17,Girona,210,Ventalló,859,438,421,17210,Ventalló,0,"0,0",0,"0,0",0,"0,0",Ventalló,Alt Empordà,172109,859
17,Girona,211,Verges,1171,572,599,17211,Verges,0,"0,0",1,"1,7",1,"0,9",Verges,Baix Empordà,172116,1171
17,Girona,212,Vidrà,167,83,84,17212,Vidrà,0,"0,0",0,"0,0",0,"0,0",Vidrà,Osona,172121,167
17,Girona,213,Vidreres,7797,4048,3749,17213,Vidreres,9,"2,4",12,"3,0",21,"2,7",Vidreres,Selva,172137,7797
17,Girona,214,Vilabertran,979,489,490,17214,Vilabertran,0,"0,0",1,"2,0",1,"1,0",Vilabertran,Alt Empordà,172142,979
17,Girona,215,Vilablareix,2897,1438,1459,17215,Vilablareix,6,"4,1",5,"3,5",11,"3,8",Vilablareix,Gironès,172155,2897
17,Girona,217,Viladamat,468,241,227,17217,Viladamat,0,"0,0",0,"0,0",0,"0,0",Viladamat,Alt Empordà,172174,468
17,Girona,216,Viladasens,200,107,93,17216,Viladasens,0,"0,0",0,"0,0",0,"0,0",Viladasens,Gironès,172168,200
17,Girona,218,Vilademuls,815,424,391,17218,Vilademuls,0,"0,0",0,"0,0",0,"0,0",Vilademuls,Pla de l'Estany,172180,815
17,Girona,220,Viladrau,1040,509,531,17220,Viladrau,0,"0,0",0,"0,0",0,"0,0",Viladrau,Osona,172207,1040
17,Girona,221,Vilafant,5394,2636,2758,17221,Vilafant,8,"2,9",8,"3,0",16,"3,0",Vilafant,Alt Empordà,172214,5394
17,Girona,223,Vilajuïga,1104,549,555,17223,Vilajuïga,2,"3,6",1,"1,8",3,"2,7",Vilajuïga,Alt Empordà,172235,1104
17,Girona,224,Vilallonga de Ter,398,212,186,17224,Vilallonga de Ter,0,"0,0",1,"4,7",1,"2,5",Vilallonga de Ter,Ripollès,172240,398
17,Girona,225,Vilamacolum,348,193,155,17225,Vilamacolum,0,"0,0",0,"0,0",0,"0,0",Vilamacolum,Alt Empordà,172253,348
17,Girona,226,Vilamalla,1181,586,595,17226,Vilamalla,1,"1,7",0,"0,0",1,"0,8",Vilamalla,Alt Empordà,172266,1181
17,Girona,227,Vilamaniscle,200,116,84,17227,Vilamaniscle,0,"0,0",0,"0,0",0,"0,0",Vilamaniscle,Alt Empordà,172272,200
17,Girona,228,Vilanant,392,197,195,17228,Vilanant,0,"0,0",0,"0,0",0,"0,0",Vilanant,Alt Empordà,172288,392
17,Girona,230,Vila-sacra,760,372,388,17230,Vila-Sacra,0,"0,0",2,"5,4",2,"2,6",Vila-sacra,Alt Empordà,172305,760
17,Girona,222,Vilaür,157,81,76,17222,Vilaür,0,"0,0",0,"0,0",0,"0,0",Vilaür,Alt Empordà,172229,157
17,Girona,233,Vilobí d'Onyar,3291,1711,1580,17233,Vilobí d'Onyar,2,"1,3",3,"1,8",5,"1,5",Vilobí d'Onyar,Selva,172333,3291
17,Girona,232,Vilopriu,202,107,95,17232,Vilopriu,,,1,"9,3",1,"5,0",Vilopriu,Baix Empordà,172327,202
25,Lleida,001,Abella de la Conca,179,96,83,25001,Abella de la Conca,0,,0,"0,0",0,"0,0",Abella de la Conca,Pallars Jussà,250019,179
25,Lleida,002,Àger,588,320,268,25002,Àger,18,,17,"53,1",35,"59,5",Àger,Noguera,250024,588
25,Lleida,003,Agramunt,5371,2689,2682,25003,Agramunt,4,,3,"1,1",7,"1,3",Agramunt,Urgell,250030,5371
25,Lleida,038,Aitona,2591,1358,1233,25038,Aitona,1,,14,"10,3",15,"5,8",Aitona,Segrià,250387,2591
25,Lleida,004,"Alamús, Els",819,412,407,25004,Els Alamús,0,,1,"2,4",1,"1,2","Alamús, els",Segrià,250045,819
25,Lleida,005,Alàs i Cerc,329,171,158,25005,Alàs i Cerc,0,,0,"0,0",0,"0,0",Alàs i Cerc,Alt Urgell,250058,329
25,Lleida,006,"Albagés, L'",369,194,175,25006,L'Albagés,0,,0,"0,0",0,"0,0","Albagés, l'",Garrigues,250061,369
25,Lleida,007,Albatàrrec,2221,1150,1071,25007,Albatàrrec,5,,1,"0,9",6,"2,7",Albatàrrec,Segrià,250077,2221
25,Lleida,008,Albesa,1556,855,701,25008,Albesa,2,,0,"0,0",2,"1,3",Albesa,Noguera,250083,1556
25,Lleida,009,"Albi, L'",764,389,375,25009,L'Albi,0,,0,"0,0",0,"0,0","Albi, l'",Garrigues,250096,764
25,Lleida,010,Alcanó,235,119,116,25010,Alcanó,1,,0,"0,0",1,"4,3",Alcanó,Segrià,250100,235
25,Lleida,011,Alcarràs,9514,4957,4557,25011,Alcarràs,7,,7,"1,4",14,"1,5",Alcarràs,Segrià,250117,9514
25,Lleida,012,Alcoletge,3420,1775,1645,25012,Alcoletge,1,,6,"3,4",7,"2,0",Alcoletge,Segrià,250122,3420
25,Lleida,013,Alfarràs,2797,1459,1338,25013,Alfarràs,2,,4,"2,7",6,"2,1",Alfarràs,Segrià,250138,2797
25,Lleida,014,Alfés,312,162,150,25014,Alfés,0,,0,"0,0",0,"0,0",Alfés,Segrià,250143,312
25,Lleida,015,Algerri,386,206,180,25015,Algerri,0,,0,"0,0",0,"0,0",Algerri,Noguera,250156,386
25,Lleida,016,Alguaire,2971,1562,1409,25016,Alguaire,3,,4,"2,6",7,"2,4",Alguaire,Segrià,250169,2971
25,Lleida,017,Alins,276,144,132,25017,Alins,0,,0,"0,0",0,"0,0",Alins,Pallars Sobirà,250175,276
25,Lleida,019,Almacelles,6791,3584,3207,25019,Almacelles,7,,4,"1,1",11,"1,6",Almacelles,Segrià,250194,6791
25,Lleida,020,Almatret,307,172,135,25020,Almatret,0,,0,"0,0",0,"0,0",Almatret,Segrià,250208,307
25,Lleida,021,Almenar,3398,1791,1607,25021,Almenar,5,,5,"2,8",10,"2,9",Almenar,Segrià,250215,3398
25,Lleida,022,Alòs de Balaguer,130,74,56,25022,Alòs de Balaguer,0,,0,"0,0",0,"0,0",Alòs de Balaguer,Noguera,250220,130
25,Lleida,023,Alpicat,6255,3134,3121,25023,Alpicat,7,,5,"1,6",12,"1,9",Alpicat,Segrià,250236,6255
25,Lleida,024,Alt Àneu,405,231,174,25024,Alt Àneu,1,,0,"0,0",1,"2,5",Alt Àneu,Pallars Sobirà,250241,405
25,Lleida,027,Anglesola,1363,682,681,25027,Anglesola,1,,0,"0,0",1,"0,7",Anglesola,Urgell,250273,1363
25,Lleida,029,Arbeca,2144,1100,1044,25029,Arbeca,0,,3,"2,7",3,"1,4",Arbeca,Garrigues,250292,2144
25,Lleida,031,Arres,65,42,23,25031,Arres,0,,0,"0,0",0,"0,0",Arres,Val d'Aran,250313,65
25,Lleida,032,Arsèguel,84,48,36,25032,Arsèguel,0,,0,"0,0",0,"0,0",Arsèguel,Alt Urgell,250328,84
25,Lleida,033,Artesa de Lleida,1504,789,715,25033,Artesa de Lleida,3,,3,"3,8",6,"4,0",Artesa de Lleida,Segrià,250334,1504
25,Lleida,034,Artesa de Segre,3432,1766,1666,25034,Artesa de Segre,1,,2,"1,1",3,"0,9",Artesa de Segre,Noguera,250349,3432
25,Lleida,036,Aspa,224,113,111,25036,Aspa,1,,0,"0,0",1,"4,5",Aspa,Segrià,250365,224
25,Lleida,037,"Avellanes i Santa Linya, Les",449,259,190,25037,Les Avellanes i Santa Linya,2,,0,"0,0",2,"4,5","Avellanes i Santa Linya, les",Noguera,250371,449
25,Lleida,039,Baix Pallars,335,182,153,25039,Baix Pallars,0,,0,"0,0",0,"0,0",Baix Pallars,Pallars Sobirà,250390,335
25,Lleida,040,Balaguer,17162,8746,8416,25040,Balaguer,51,,36,"4,1",87,"5,1",Balaguer,Noguera,250404,17162
25,Lleida,041,Barbens,878,467,411,25041,Barbens,0,,2,"4,3",2,"2,3",Barbens,Pla d'Urgell,250411,878
25,Lleida,042,"Baronia de Rialb, La",237,121,116,25042,La Baronia de Rialb,0,,1,"8,3",1,"4,2","Baronia de Rialb, la",Noguera,250426,237
25,Lleida,044,Bassella,224,112,112,25044,Bassella,0,,1,"8,9",1,"4,5",Bassella,Alt Urgell,250447,224
25,Lleida,045,Bausen,58,30,28,25045,Bausen,0,,0,"0,0",0,"0,0",Bausen,Val d'Aran,250450,58
25,Lleida,046,Belianes,525,269,256,25046,Belianes,1,,0,"0,0",1,"1,9",Belianes,Urgell,250463,525
25,Lleida,170,Bellaguarda,287,152,135,25170,Bellaguarda,4,,3,"19,7",7,"24,4",Bellaguarda,Garrigues,251706,287
25,Lleida,047,Bellcaire d'Urgell,1230,627,603,25047,Bellcaire d'Urgell,2,,0,"0,0",2,"1,6",Bellcaire d'Urgell,Noguera,250479,1230
25,Lleida,048,Bell-lloc d'Urgell,2315,1139,1176,25048,Bell-Lloc d'Urgell,5,,6,"5,3",11,"4,8",Bell-lloc d'Urgell,Pla d'Urgell,250485,2315
25,Lleida,049,Bellmunt d'Urgell,185,89,96,25049,Bellmunt d'Urgell,0,,0,"0,0",0,"0,0",Bellmunt d'Urgell,Noguera,250498,185
25,Lleida,050,Bellpuig,5133,2705,2428,25050,Bellpuig,3,,1,"0,4",4,"0,8",Bellpuig,Urgell,250501,5133
25,Lleida,051,Bellver de Cerdanya,1937,1009,928,25051,Bellver de Cerdanya,1,,2,"2,0",3,"1,5",Bellver de Cerdanya,Cerdanya,250518,1937
25,Lleida,052,Bellvís,2255,1149,1106,25052,Bellvís,1,,3,"2,6",4,"1,8",Bellvís,Pla d'Urgell,250523,2255
25,Lleida,053,Benavent de Segrià,1499,781,718,25053,Benavent de Segrià,3,,3,"3,8",6,"4,0",Benavent de Segrià,Segrià,250539,1499
25,Lleida,055,Biosca,176,94,82,25055,Biosca,0,,0,"0,0",0,"0,0",Biosca,Segarra,250557,176
25,Lleida,057,"Bòrdes, Es",259,144,115,25057,Es Bòrdes,0,,0,"0,0",0,"0,0","Bòrdes, Es",Val d'Aran,250576,259
25,Lleida,058,"Borges Blanques, Les",6087,3105,2982,25058,Les Borges Blanques,5,,2,"0,6",7,"1,1","Borges Blanques, les",Garrigues,250582,6087
25,Lleida,059,Bossòst,1109,542,567,25059,Bossòst,10,,3,"5,5",13,"11,7",Bossòst,Val d'Aran,250595,1109
25,Lleida,056,Bovera,247,133,114,25056,Bovera,0,,0,"0,0",0,"0,0",Bovera,Garrigues,250560,247
25,Lleida,060,Cabanabona,75,36,39,25060,Cabanabona,0,,0,"0,0",0,"0,0",Cabanabona,Noguera,250609,75
25,Lleida,061,Cabó,92,49,43,25061,Cabó,0,,0,"0,0",0,"0,0",Cabó,Alt Urgell,250616,92
25,Lleida,062,Camarasa,817,410,407,25062,Camarasa,3,,4,"9,8",7,"8,6",Camarasa,Noguera,250621,817
25,Lleida,063,Canejan,107,57,50,25063,Canejan,0,,0,"0,0",0,"0,0",Canejan,Val d'Aran,250637,107
25,Lleida,904,Castell de Mur,183,104,79,25904,Castell de Mur,0,,0,"0,0",0,"0,0",Castell de Mur,Pallars Jussà,259046,183
25,Lleida,064,Castellar de la Ribera,134,67,67,25064,Castellar de la Ribera,0,,0,"0,0",0,"0,0",Castellar de la Ribera,Solsonès,250642,134
25,Lleida,067,Castelldans,960,511,449,25067,Castelldans,0,,0,"0,0",0,"0,0",Castelldans,Garrigues,250674,960
25,Lleida,068,Castellnou de Seana,683,361,322,25068,Castellnou de Seana,0,,0,"0,0",0,"0,0",Castellnou de Seana,Pla d'Urgell,250680,683
25,Lleida,069,Castelló de Farfanya,536,288,248,25069,Castelló de Farfanya,0,,1,"3,5",1,"1,9",Castelló de Farfanya,Noguera,250693,536
25,Lleida,070,Castellserà,1003,506,497,25070,Castellserà,3,,1,"2,0",4,"4,0",Castellserà,Urgell,250707,1003
25,Lleida,071,Cava,47,29,18,25071,Cava,0,,0,"0,0",0,"0,0",Cava,Alt Urgell,250714,47
25,Lleida,072,Cervera,9180,4670,4510,25072,Cervera,12,,11,"2,4",23,"2,5",Cervera,Segarra,250729,9180
25,Lleida,073,Cervià de les Garrigues,640,336,304,25073,Cervià de les Garrigues,1,,1,"3,0",2,"3,1",Cervià de les Garrigues,Garrigues,250735,640
25,Lleida,074,Ciutadilla,208,111,97,25074,Ciutadilla,0,,0,"0,0",0,"0,0",Ciutadilla,Urgell,250740,208
25,Lleida,075,Clariana de Cardener,157,82,75,25075,Clariana de Cardener,0,,0,"0,0",0,"0,0",Clariana de Cardener,Solsonès,250753,157
25,Lleida,076,"Cogul, El",158,88,70,25076,El Cogul,0,,0,"0,0",0,"0,0","Cogul, el",Garrigues,250766,158
25,Lleida,077,Coll de Nargó,550,285,265,25077,Coll de Nargó,0,,0,"0,0",0,"0,0",Coll de Nargó,Alt Urgell,250772,550
25,Lleida,163,"Coma i la Pedra, La",265,157,108,25163,La Coma i la Pedra,0,,0,"0,0",0,"0,0","Coma i la Pedra, la",Solsonès,251636,265
25,Lleida,161,Conca de Dalt,418,213,205,25161,Conca de Dalt,1,,1,"4,7",2,"4,8",Conca de Dalt,Pallars Jussà,251615,418
25,Lleida,078,Corbins,1444,787,657,25078,Corbins,0,,0,"0,0",0,"0,0",Corbins,Segrià,250788,1444
25,Lleida,079,Cubells,343,180,163,25079,Cubells,0,,0,"0,0",0,"0,0",Cubells,Noguera,250791,343
25,Lleida,081,"Espluga Calba, L'",341,171,170,25081,L'Espluga Calba,1,,0,"0,0",1,"2,9","Espluga Calba, l'",Garrigues,250812,341
25,Lleida,082,Espot,364,193,171,25082,Espot,1,,1,"5,2",2,"5,5",Espot,Pallars Sobirà,250827,364
25,Lleida,088,Estamariu,118,68,50,25088,Estamariu,0,,0,"0,0",0,"0,0",Estamariu,Alt Urgell,250886,118
25,Lleida,085,Estaràs,162,85,77,25085,Estaràs,0,,0,"0,0",0,"0,0",Estaràs,Segarra,250851,162
25,Lleida,086,Esterri d'Àneu,772,364,408,25086,Esterri d'Àneu,1,,2,"5,5",3,"3,9",Esterri d'Àneu,Pallars Sobirà,250864,772
25,Lleida,087,Esterri de Cardós,70,37,33,25087,Esterri de Cardós,0,,0,"0,0",0,"0,0",Esterri de Cardós,Pallars Sobirà,250870,70
25,Lleida,089,Farrera,116,65,51,25089,Farrera,0,,0,"0,0",0,"0,0",Farrera,Pallars Sobirà,250899,116
25,Lleida,908,Fígols i Alinyà,252,145,107,25908,Fígols i Alinyà,0,,0,"0,0",0,"0,0",Fígols i Alinyà,Alt Urgell,259084,252
25,Lleida,092,"Floresta, La",147,79,68,25092,La Floresta,0,,0,"0,0",0,"0,0","Floresta, la",Garrigues,250925,147
25,Lleida,093,Fondarella,784,387,397,25093,Fondarella,1,,0,"0,0",1,"1,3",Fondarella,Pla d'Urgell,250931,784
25,Lleida,094,Foradada,186,108,78,25094,Foradada,0,,0,"0,0",0,"0,0",Foradada,Noguera,250946,186
25,Lleida,096,"Fuliola, La",1248,619,629,25096,La Fuliola,14,,17,"27,5",31,"24,8","Fuliola, la",Urgell,250962,1248
25,Lleida,097,Fulleda,85,44,41,25097,Fulleda,0,,0,"0,0",0,"0,0",Fulleda,Garrigues,250978,85
25,Lleida,098,Gavet de la Conca,261,129,132,25098,Gavet de la Conca,2,,1,"7,8",3,"11,5",Gavet de la Conca,Pallars Jussà,250984,261
25,Lleida,912,Gimenells i el Pla de la Font,1111,595,516,25912,Gimenells i el Pla de la Font,1,,0,"0,0",1,"0,9",Gimenells i el Pla de la Font,Segrià,259123,1111
25,Lleida,099,Golmés,1840,917,923,25099,Golmés,2,,0,"0,0",2,"1,1",Golmés,Pla d'Urgell,250997,1840
25,Lleida,100,Gósol,206,118,88,25100,Gósol,0,,0,"0,0",0,"0,0",Gósol,Berguedà,251001,206
25,Lleida,101,"Granadella, La",712,387,325,25101,La Granadella,0,,2,"5,2",2,"2,8","Granadella, la",Garrigues,251018,712
25,Lleida,102,"Granja d'Escarp, La",936,514,422,25102,La Granja d'Escarp,0,,0,"0,0",0,"0,0","Granja d'Escarp, la",Segrià,251023,936
25,Lleida,103,Granyanella,148,82,66,25103,Granyanella,0,,0,"0,0",0,"0,0",Granyanella,Segarra,251039,148
25,Lleida,105,Granyena de les Garrigues,132,78,54,25105,Granyena de les Garrigues,0,,0,"0,0",0,"0,0",Granyena de les Garrigues,Garrigues,251057,132
25,Lleida,104,Granyena de Segarra,142,76,66,25104,Granyena de Segarra,0,,0,"0,0",0,"0,0",Granyena de Segarra,Segarra,251044,142
25,Lleida,109,Guimerà,265,140,125,25109,Guimerà,0,,0,"0,0",0,"0,0",Guimerà,Urgell,251095,265
25,Lleida,903,"Guingueta d'Àneu, La",297,159,138,25903,La Guingueta d'Àneu,1,,1,"6,3",2,"6,7","Guingueta d'Àneu, la",Pallars Sobirà,259031,297
25,Lleida,110,Guissona,7136,3810,3326,25110,Guissona,33,,20,"5,2",53,"7,4",Guissona,Segarra,251109,7136
25,Lleida,111,Guixers,134,84,50,25111,Guixers,0,,0,"0,0",0,"0,0",Guixers,Solsonès,251116,134
25,Lleida,115,Isona i Conca Dellà,1019,548,471,25115,Isona i Conca Dellà,0,,1,"1,8",1,"1,0",Isona i Conca Dellà,Pallars Jussà,251155,1019
25,Lleida,112,Ivars de Noguera,334,171,163,25112,Ivars de Noguera,0,,1,"5,8",1,"3,0",Ivars de Noguera,Noguera,251121,334
25,Lleida,113,Ivars d'Urgell,1531,801,730,25113,Ivars d'Urgell,0,,0,"0,0",0,"0,0",Ivars d'Urgell,Pla d'Urgell,251137,1531
25,Lleida,114,Ivorra,104,57,47,25114,Ivorra,0,,0,"0,0",0,"0,0",Ivorra,Segarra,251142,104
25,Lleida,910,Josa i Tuixén,106,58,48,25910,Josa i Tuixén,0,,0,"0,0",0,"0,0",Josa i Tuixén,Alt Urgell,259101,106
25,Lleida,118,Juncosa,386,204,182,25118,Juncosa,0,,0,"0,0",0,"0,0",Juncosa,Garrigues,251180,386
25,Lleida,119,Juneda,3475,1854,1621,25119,Juneda,11,,4,"2,2",15,"4,3",Juneda,Garrigues,251193,3475
25,Lleida,121,Les,946,463,483,25121,Les,1,,0,"0,0",1,"1,1",Les,Val d'Aran,251214,946
25,Lleida,122,Linyola,2700,1365,1335,25122,Linyola,0,,0,"0,0",0,"0,0",Linyola,Pla d'Urgell,251229,2700
25,Lleida,123,Lladorre,230,116,114,25123,Lladorre,0,,0,"0,0",0,"0,0",Lladorre,Pallars Sobirà,251235,230
25,Lleida,124,Lladurs,176,91,85,25124,Lladurs,0,,0,"0,0",0,"0,0",Lladurs,Solsonès,251240,176
25,Lleida,125,Llardecans,451,236,215,25125,Llardecans,1,,0,"0,0",1,"2,2",Llardecans,Segrià,251253,451
25,Lleida,126,Llavorsí,352,180,172,25126,Llavorsí,0,,0,"0,0",0,"0,0",Llavorsí,Pallars Sobirà,251266,352
25,Lleida,120,Lleida,138956,68657,70299,25120,Lleida,240,,206,"3,0",446,"3,2",Lleida,Segrià,251207,138956
25,Lleida,127,Lles de Cerdanya,253,148,105,25127,Lles de Cerdanya,0,,1,"6,8",1,"4,0",Lles de Cerdanya,Cerdanya,251272,253
25,Lleida,128,Llimiana,145,88,57,25128,Llimiana,0,,0,"0,0",0,"0,0",Llimiana,Pallars Jussà,251288,145
25,Lleida,129,Llobera,188,104,84,25129,Llobera,0,,0,"0,0",0,"0,0",Llobera,Solsonès,251291,188
25,Lleida,133,Maials,920,517,403,25133,Maials,5,,2,"3,9",7,"7,6",Maials,Segrià,251333,920
25,Lleida,130,Maldà,220,109,111,25130,Maldà,0,,0,"0,0",0,"0,0",Maldà,Urgell,251305,220
25,Lleida,131,Massalcoreig,598,338,260,25131,Massalcoreig,0,,0,"0,0",0,"0,0",Massalcoreig,Segrià,251312,598
25,Lleida,132,Massoteres,218,119,99,25132,Massoteres,1,,0,"0,0",1,"4,6",Massoteres,Segarra,251327,218
25,Lleida,134,Menàrguens,806,440,366,25134,Menàrguens,0,,0,"0,0",0,"0,0",Menàrguens,Noguera,251348,806
25,Lleida,135,Miralcamp,1351,677,674,25135,Miralcamp,2,,0,"0,0",2,"1,5",Miralcamp,Pla d'Urgell,251351,1351
25,Lleida,137,Mollerussa,14683,7543,7140,25137,Mollerussa,13,,10,"1,3",23,"1,6",Mollerussa,Pla d'Urgell,251370,14683
25,Lleida,136,"Molsosa, La",107,53,54,25136,"Molsosa, La",0,,0,"0,0",0,"0,0","Molsosa, la",Solsonès,251364,107
25,Lleida,139,Montellà i Martinet,579,324,255,25139,Montellà i Martinet,0,,0,"0,0",0,"0,0",Montellà i Martinet,Cerdanya,251399,579
25,Lleida,140,Montferrer i Castellbò,1041,566,475,25140,Montferrer i Castellbò,1,,2,"3,5",3,"2,9",Montferrer i Castellbò,Alt Urgell,251403,1041
25,Lleida,138,Montgai,625,329,296,25138,Montgai,1,,1,"3,0",2,"3,2",Montgai,Noguera,251386,625
25,Lleida,142,Montoliu de Lleida,489,251,238,25142,Montoliu de Lleida,0,,0,"0,0",0,"0,0",Montoliu de Lleida,Segrià,251425,489
25,Lleida,141,Montoliu de Segarra,179,100,79,25141,Montoliu de Segarra,0,,0,"0,0",0,"0,0",Montoliu de Segarra,Segarra,251410,179
25,Lleida,143,Montornès de Segarra,100,47,53,25143,Montornès de Segarra,0,,0,"0,0",0,"0,0",Montornès de Segarra,Segarra,251431,100
25,Lleida,145,Nalec,87,45,42,25145,Nalec,0,,0,"0,0",0,"0,0",Nalec,Urgell,251459,87
25,Lleida,025,Naut Aran,1803,935,868,25025,Naut Aran,0,,2,"2,1",2,"1,1",Naut Aran,Val d'Aran,250254,1803
25,Lleida,146,Navès,280,147,133,25146,Navès,1,,0,"0,0",1,"3,6",Navès,Solsonès,251462,280
25,Lleida,148,Odèn,249,149,100,25148,Odèn,0,,0,"0,0",0,"0,0",Odèn,Solsonès,251484,249
25,Lleida,149,Oliana,1810,906,904,25149,Oliana,2,,6,"6,6",8,"4,4",Oliana,Alt Urgell,251497,1810
25,Lleida,150,Oliola,197,106,91,25150,Oliola,0,,0,"0,0",0,"0,0",Oliola,Noguera,251500,197
25,Lleida,151,Olius,986,527,459,25151,Olius,1,,1,"1,9",2,"2,0",Olius,Solsonès,251517,986
25,Lleida,152,"Oluges, Les",167,88,79,25152,"Oluges, Les",0,,0,"0,0",0,"0,0","Oluges, les",Segarra,251522,167
25,Lleida,153,"Omellons, Els",211,111,100,25153,Els Omellons,0,,1,"9,0",1,"4,7","Omellons, els",Garrigues,251538,211
25,Lleida,154,"Omells de na Gaia, Els",131,72,59,25154,Els Omells de na Gaia,0,,0,"0,0",0,"0,0","Omells de na Gaia, els",Urgell,251543,131
25,Lleida,155,Organyà,784,388,396,25155,Organyà,0,,1,"2,6",1,"1,3",Organyà,Alt Urgell,251556,784
25,Lleida,156,Os de Balaguer,994,507,487,25156,Os de Balaguer,1,,0,"0,0",1,"1,0",Os de Balaguer,Noguera,251569,994
25,Lleida,157,Ossó de Sió,204,98,106,25157,Ossó de Sió,0,,0,"0,0",0,"0,0",Ossó de Sió,Urgell,251575,204
25,Lleida,158,"Palau d'Anglesola, El",2166,1061,1105,25158,El Palau d'Anglesola,0,,3,"2,8",3,"1,4","Palau d'Anglesola, el",Pla d'Urgell,251581,2166
25,Lleida,164,Penelles,452,262,190,25164,Penelles,0,,0,"0,0",0,"0,0",Penelles,Noguera,251641,452
25,Lleida,165,Peramola,347,177,170,25165,Peramola,0,,0,"0,0",0,"0,0",Peramola,Alt Urgell,251654,347
25,Lleida,166,Pinell de Solsonès,200,118,82,25166,Pinell de Solsonès,0,,0,"0,0",0,"0,0",Pinell de Solsonès,Solsonès,251667,200
25,Lleida,167,Pinós,287,151,136,25167,Pinós,0,,0,"0,0",0,"0,0",Pinós,Solsonès,251673,287
25,Lleida,911,"Plans de Sió, Els",506,272,234,25911,Els Plans de Sió,0,,0,"0,0",0,"0,0","Plans de Sió, els",Segarra,259118,506
25,Lleida,168,"Poal, El",648,340,308,25168,El Poal,0,,1,"2,9",1,"1,5","Poal, el",Pla d'Urgell,251689,648
25,Lleida,169,"Pobla de Cérvoles, La",191,107,84,25169,La Pobla de Cérvoles,0,,0,"0,0",0,"0,0","Pobla de Cérvoles, la",Garrigues,251692,191
25,Lleida,171,"Pobla de Segur, La",2984,1469,1515,25171,La Pobla de Segur,30,,24,"16,3",54,"18,1","Pobla de Segur, la",Pallars Jussà,251713,2984
25,Lleida,030,"Pont de Bar, El",157,87,70,25030,El Pont de Bar,0,,0,"0,0",0,"0,0","Pont de Bar, el",Alt Urgell,250306,157
25,Lleida,173,"Pont de Suert, El",2220,1107,1113,25173,El Pont de Suert,0,,3,"2,7",3,"1,4","Pont de Suert, el",Alta Ribagorça,251734,2220
25,Lleida,172,Ponts,2601,1305,1296,25172,Ponts,2,,2,"1,5",4,"1,5",Ponts,Noguera,251728,2601
25,Lleida,174,"Portella, La",728,412,316,25174,La Portella,0,,1,"2,4",1,"1,4","Portella, la",Segrià,251749,728
25,Lleida,175,Prats i Sansor,219,114,105,25175,Prats i Sansor,0,,0,"0,0",0,"0,0",Prats i Sansor,Cerdanya,251752,219
25,Lleida,176,Preixana,385,199,186,25176,Preixana,1,,0,"0,0",1,"2,6",Preixana,Urgell,251765,385
25,Lleida,177,Preixens,432,218,214,25177,Preixens,0,,0,"0,0",0,"0,0",Preixens,Noguera,251771,432
25,Lleida,179,Prullans,231,109,122,25179,Prullans,0,,0,"0,0",0,"0,0",Prullans,Cerdanya,251790,231
25,Lleida,180,Puiggròs,276,138,138,25180,Puiggròs,1,,0,"0,0",1,"3,6",Puiggròs,Garrigues,251804,276
25,Lleida,181,Puigverd d'Agramunt,255,146,109,25181,Puigverd d'Agramunt,1,,0,"0,0",1,"3,9",Puigverd d'Agramunt,Urgell,251811,255
25,Lleida,182,Puigverd de Lleida,1355,701,654,25182,Puigverd de Lleida,2,,0,"0,0",2,"1,5",Puigverd de Lleida,Segrià,251826,1355
25,Lleida,183,Rialp,661,330,331,25183,Rialp,1,,0,"0,0",1,"1,5",Rialp,Pallars Sobirà,251832,661
25,Lleida,905,Ribera d'Ondara,426,213,213,25905,Ribera d'Ondara,3,,0,"0,0",3,"7,0",Ribera d'Ondara,Segarra,259059,426
25,Lleida,185,Ribera d'Urgellet,935,488,447,25185,Ribera d'Urgellet,0,,1,"2,0",1,"1,1",Ribera d'Urgellet,Alt Urgell,251850,935
25,Lleida,186,Riner,263,132,131,25186,Riner,1,,0,"0,0",1,"3,8",Riner,Solsonès,251863,263
25,Lleida,913,Riu de Cerdanya,93,55,38,25913,Riu de Cerdanya,0,,0,"0,0",0,"0,0",Riu de Cerdanya,Cerdanya,259139,93
25,Lleida,189,Rosselló,3145,1602,1543,25189,Rosselló,4,,3,"1,9",7,"2,2",Rosselló,Segrià,251898,3145
25,Lleida,190,Salàs de Pallars,320,174,146,25190,Salàs de Pallars,1,,1,"5,7",2,"6,3",Salàs de Pallars,Pallars Jussà,251902,320
25,Lleida,191,Sanaüja,380,202,178,25191,Sanaüja,0,,0,"0,0",0,"0,0",Sanaüja,Segarra,251919,380
25,Lleida,196,Sant Esteve de la Sarga,124,72,52,25196,Sant Esteve de la Sarga,0,,0,"0,0",0,"0,0",Sant Esteve de la Sarga,Pallars Jussà,251961,124
25,Lleida,192,Sant Guim de Freixenet,1025,538,487,25192,Sant Guim de Freixenet,1,,1,"1,9",2,"2,0",Sant Guim de Freixenet,Segarra,251924,1025
25,Lleida,197,Sant Guim de la Plana,185,106,79,25197,Sant Guim de la Plana,0,,0,"0,0",0,"0,0",Sant Guim de la Plana,Segarra,251977,185
25,Lleida,193,Sant Llorenç de Morunys,949,457,492,25193,Sant Llorenç de Morunys,0,,0,"0,0",0,"0,0",Sant Llorenç de Morunys,Solsonès,251930,949
25,Lleida,902,Sant Martí de Riucorb,646,334,312,25902,Sant Martí de Riucorb,1,,0,"0,0",1,"1,5",Sant Martí de Riucorb,Urgell,259025,646
25,Lleida,194,Sant Ramon,491,254,237,25194,Sant Ramon,1,,1,"3,9",2,"4,1",Sant Ramon,Segarra,251945,491
25,Lleida,201,Sarroca de Bellera,121,68,53,25201,Sarroca de Bellera,0,,0,"0,0",0,"0,0",Sarroca de Bellera,Pallars Jussà,252017,121
25,Lleida,200,Sarroca de Lleida,363,200,163,25200,Sarroca de Lleida,0,,0,"0,0",0,"0,0",Sarroca de Lleida,Segrià,252000,363
25,Lleida,202,Senterada,137,80,57,25202,Senterada,0,,0,"0,0",0,"0,0",Senterada,Pallars Jussà,252022,137
25,Lleida,035,"Sentiu de Sió, La",406,216,190,25035,La Sentiu de Sió,2,,0,"0,0",2,"4,9","Sentiu de Sió, la",Noguera,250352,406
25,Lleida,204,Seròs,1922,1029,893,25204,Seròs,0,,2,"1,9",2,"1,0",Seròs,Segrià,252043,1922
25,Lleida,203,"Seu d'Urgell, La",12089,5842,6247,25203,La Seu d'Urgell,13,,16,"2,7",29,"2,4","Seu d'Urgell, la",Alt Urgell,252038,12089
25,Lleida,205,Sidamon,734,383,351,25205,Sidamon,1,,1,"2,6",2,"2,7",Sidamon,Pla d'Urgell,252056,734
25,Lleida,206,"Soleràs, El",332,173,159,25206,El Soleràs,0,,0,"0,0",0,"0,0","Soleràs, el",Garrigues,252069,332
25,Lleida,207,Solsona,9094,4488,4606,25207,Solsona,4,,2,"0,4",6,"0,7",Solsona,Solsonès,252075,9094
25,Lleida,208,Soriguera,410,220,190,25208,Soriguera,0,,0,"0,0",0,"0,0",Soriguera,Pallars Sobirà,252081,410
25,Lleida,209,Sort,2149,1077,1072,25209,Sort,2,,3,"2,8",5,"2,3",Sort,Pallars Sobirà,252094,2149
25,Lleida,210,Soses,1763,923,840,25210,Soses,2,,1,"1,1",3,"1,7",Soses,Segrià,252108,1763
25,Lleida,211,Sudanell,853,465,388,25211,Sudanell,0,,1,"2,2",1,"1,2",Sudanell,Segrià,252115,853
25,Lleida,212,Sunyer,352,205,147,25212,Sunyer,0,,0,"0,0",0,"0,0",Sunyer,Segrià,252120,352
25,Lleida,215,Talarn,585,387,198,25215,Talarn,0,,0,"0,0",0,"0,0",Talarn,Pallars Jussà,252154,585
25,Lleida,216,Talavera,283,158,125,25216,Talavera,1,,1,"6,3",2,"7,1",Talavera,Segarra,252167,283
25,Lleida,217,Tàrrega,17098,8489,8609,25217,Tàrrega,14,,25,"2,9",39,"2,3",Tàrrega,Urgell,252173,17098
25,Lleida,218,Tarrés,106,56,50,25218,Tarrés,0,,0,"0,0",0,"0,0",Tarrés,Garrigues,252189,106
25,Lleida,219,Tarroja de Segarra,187,104,83,25219,Tarroja de Segarra,0,,0,"0,0",0,"0,0",Tarroja de Segarra,Segarra,252192,187
25,Lleida,220,Térmens,1333,678,655,25220,Térmens,1,,1,"1,5",2,"1,5",Térmens,Noguera,252206,1333
25,Lleida,221,Tírvia,131,63,68,25221,Tírvia,0,,0,"0,0",0,"0,0",Tírvia,Pallars Sobirà,252213,131
25,Lleida,222,Tiurana,73,33,40,25222,Tiurana,0,,0,"0,0",0,"0,0",Tiurana,Noguera,252228,73
25,Lleida,223,Torà,1255,639,616,25223,Torà,0,,0,"0,0",0,"0,0",Torà,Segarra,252234,1255
25,Lleida,224,"Torms, Els",144,77,67,25224,"Torms, Els",0,,0,"0,0",0,"0,0","Torms, els",Garrigues,252249,144
25,Lleida,225,Tornabous,858,461,397,25225,Tornabous,2,,3,"6,5",5,"5,8",Tornabous,Urgell,252252,858
25,Lleida,227,"Torre de Cabdella, La",760,383,377,25227,La Torre de Cabdella,0,,0,"0,0",0,"0,0","Torre de Cabdella, la",Pallars Jussà,252271,760
25,Lleida,226,Torrebesses,282,150,132,25226,Torrebesses,0,,0,"0,0",0,"0,0",Torrebesses,Segrià,252265,282
25,Lleida,228,Torrefarrera,4605,2328,2277,25228,Torrefarrera,4,,8,"3,4",12,"2,6",Torrefarrera,Segrià,252287,4605
25,Lleida,907,Torrefeta i Florejacs,602,322,280,25907,Torrefeta i florejacs,2,,2,"6,2",4,"6,6",Torrefeta i Florejacs,Segarra,259078,602
25,Lleida,230,Torregrossa,2202,1140,1062,25230,Torregrossa,5,,1,"0,9",6,"2,7",Torregrossa,Pla d'Urgell,252304,2202
25,Lleida,231,Torrelameu,743,433,310,25231,Torrelameu,0,,1,"2,3",1,"1,3",Torrelameu,Noguera,252311,743
25,Lleida,232,Torres de Segre,2277,1179,1098,25232,Torres del Segre,5,,1,"0,8",6,"2,6",Torres de Segre,Segrià,252326,2277
25,Lleida,233,Torre-serona,397,208,189,25233,Torre-serona,0,,0,"0,0",0,"0,0",Torre-serona,Segrià,252332,397
25,Lleida,234,Tremp,5844,2884,2960,25234,Tremp,7,,6,"2,1",13,"2,2",Tremp,Pallars Jussà,252347,5844
25,Lleida,043,"Vall de Boí, La",1021,546,475,25043,La Vall de Boí,1,,0,"0,0",1,"1,0","Vall de Boí, la",Alta Ribagorça,250432,1021
25,Lleida,901,Vall de Cardós,364,195,169,25901,Vall de Cardós,0,,0,"0,0",0,"0,0",Vall de Cardós,Pallars Sobirà,259010,364
25,Lleida,238,Vallbona de les Monges,233,120,113,25238,Vallbona de les Monges,0,,0,"0,0",0,"0,0",Vallbona de les Monges,Urgell,252385,233
25,Lleida,240,Vallfogona de Balaguer,1876,937,939,25240,Vallfogona de Balaguer,1,,1,"1,1",2,"1,1",Vallfogona de Balaguer,Noguera,252402,1876
25,Lleida,906,"Valls d'Aguilar, Les",260,145,115,25906,Les Valls d'Aguilar,0,,0,"0,0",0,"0,0","Valls d'Aguilar, les",Alt Urgell,259062,260
25,Lleida,239,"Valls de Valira, Les",791,412,379,25239,Les Valls de Valira,0,,1,"2,4",1,"1,3","Valls de Valira, les",Alt Urgell,252398,791
25,Lleida,909,"Vansa i Fórnols, La",161,84,77,25909,La Vansa i Fórnols,0,,0,"0,0",0,"0,0","Vansa i Fórnols, la",Alt Urgell,259097,161
25,Lleida,242,Verdú,919,441,478,25242,Verdú,2,,0,"0,0",2,"2,2",Verdú,Urgell,252424,919
25,Lleida,243,Vielha e Mijaran,5559,2837,2722,25243,Vielha e Mijaran,27,,19,"6,7",46,"8,3",Vielha e Mijaran,Val d'Aran,252430,5559
25,Lleida,244,Vilagrassa,541,278,263,25244,Vilagrassa,1,,3,"10,8",4,"7,4",Vilagrassa,Urgell,252445,541
25,Lleida,245,Vilaller,561,294,267,25245,Vilaller,1,,0,"0,0",1,"1,8",Vilaller,Alta Ribagorça,252458,561
25,Lleida,247,Vilamòs,187,100,87,25247,Vilamòs,0,,0,"0,0",0,"0,0",Vilamòs,Val d'Aran,252477,187
25,Lleida,248,Vilanova de Bellpuig,1181,599,582,25248,Vilanova de Bellpuig,2,,0,"0,0",2,"1,7",Vilanova de Bellpuig,Pla d'Urgell,252483,1181
25,Lleida,254,Vilanova de la Barca,1036,535,501,25254,Vilanova de la Barca,1,,0,"0,0",1,"1,0",Vilanova de la Barca,Segrià,252542,1036
25,Lleida,249,Vilanova de l'Aguda,197,97,100,25249,Vilanova de l'Aguda,0,,0,"0,0",0,"0,0",Vilanova de l'Aguda,Noguera,252496,197
25,Lleida,250,Vilanova de Meià,389,223,166,25250,Vilanova de Meià,0,,0,"0,0",0,"0,0",Vilanova de Meià,Noguera,252509,389
25,Lleida,251,Vilanova de Segrià,977,518,459,25251,Vilanova de Segrià,2,,0,"0,0",2,"2,0",Vilanova de Segrià,Segrià,252516,977
25,Lleida,252,Vila-sana,742,376,366,25252,Vila-sana,0,,0,"0,0",0,"0,0",Vila-sana,Pla d'Urgell,252521,742
25,Lleida,253,"Vilosell, El",169,88,81,25253,El Vilosell,0,,0,"0,0",0,"0,0","Vilosell, el",Garrigues,252537,169
25,Lleida,255,Vinaixa,470,249,221,25255,Vinaixa,,,1,"4,0",1,"2,1",Vinaixa,Garrigues,252555,470
43,Tarragona,001,Aiguamúrcia,901,465,436,43001,Aiguamúrcia,1,,0,"0,0",1,"1,1",Aiguamúrcia,Alt Camp,430017,901
43,Tarragona,002,Albinyana,2438,1243,1195,43002,Albinyana,4,,5,"4,0",9,"3,7",Albinyana,Baix Penedès,430022,2438
43,Tarragona,003,"Albiol, L'",485,253,232,43003,l'Albiol,0,,1,"4,0",1,"2,1","Albiol, l'",Baix Camp,430038,485
43,Tarragona,004,Alcanar,9418,4748,4670,43004,Alcanar,3,,1,"0,2",4,"0,4",Alcanar,Montsià,430043,9418
43,Tarragona,005,Alcover,5064,2499,2565,43005,Alcover,1,,1,"0,4",2,"0,4",Alcover,Alt Camp,430056,5064
43,Tarragona,904,"Aldea, L'",4160,2197,1963,43904,l'Aldea,0,,1,"0,5",1,"0,2","Aldea, l'",Baix Ebre,439044,4160
43,Tarragona,006,Aldover,882,445,437,43006,Aldover,2,,0,"0,0",2,"2,3",Aldover,Baix Ebre,430069,882
43,Tarragona,007,"Aleixar, L'",873,450,423,43007,L'Aleixar,4,,0,"0,0",4,"4,6","Aleixar, l'",Baix Camp,430075,873
43,Tarragona,008,Alfara de Carles,377,199,178,43008,Alfara de Carles,0,,0,"0,0",0,"0,0",Alfara de Carles,Baix Ebre,430081,377
43,Tarragona,009,Alforja,1801,921,880,43009,Alforja,2,,2,"2,2",4,"2,2",Alforja,Baix Camp,430094,1801
43,Tarragona,010,Alió,439,208,231,43010,Alió,0,,0,"0,0",0,"0,0",Alió,Alt Camp,430108,439
43,Tarragona,011,Almoster,1351,680,671,43011,Almoster,0,,4,"5,9",4,"3,0",Almoster,Baix Camp,430115,1351
43,Tarragona,012,Altafulla,5243,2555,2688,43012,Altafulla,3,,2,"0,8",5,"1,0",Altafulla,Tarragonès,430120,5243
43,Tarragona,013,"Ametlla de Mar, L'",6787,3384,3403,43013,L'Ametlla de Mar,2,,2,"0,6",4,"0,6","Ametlla de Mar, l'",Baix Ebre,430136,6787
43,Tarragona,906,"Ampolla, L'",3205,1631,1574,43906,L'Ampolla,1,,0,"0,0",1,"0,3","Ampolla, l'",Baix Ebre,439060,3205
43,Tarragona,014,Amposta,20738,10449,10289,43014,Amposta,9,,8,"0,8",17,"0,8",Amposta,Montsià,430141,20738
43,Tarragona,016,"Arboç, L'",5517,2852,2665,43016,L'Arboç,12,,9,"3,2",21,"3,8","Arboç, l'",Baix Penedès,430167,5517
43,Tarragona,015,Arbolí,137,79,58,43015,Arbolí,0,,0,"0,0",0,"0,0",Arbolí,Baix Camp,430154,137
43,Tarragona,017,"Argentera, L'",124,70,54,43017,L' Argentera,0,,0,"0,0",0,"0,0","Argentera, l'",Baix Camp,430173,124
43,Tarragona,018,Arnes,455,224,231,43018,Arnes,0,,0,"0,0",0,"0,0",Arnes,Terra Alta,430189,455
43,Tarragona,019,Ascó,1660,856,804,43019,Ascó,1,,0,"0,0",1,"0,6",Ascó,Ribera d'Ebre,430192,1660
43,Tarragona,020,Banyeres del Penedès,3170,1612,1558,43020,Banyeres del Penedès,4,,7,"4,3",11,"3,5",Banyeres del Penedès,Baix Penedès,430206,3170
43,Tarragona,021,Barberà de la Conca,473,257,216,43021,Barberà de la Conca,1,,0,"0,0",1,"2,1",Barberà de la Conca,Conca de Barberà,430213,473
43,Tarragona,022,Batea,1890,944,946,43022,Batea,0,,1,"1,1",1,"0,5",Batea,Terra Alta,430228,1890
43,Tarragona,023,Bellmunt del Priorat,280,145,135,43023,Bellmunt del Priorat,0,,0,"0,0",0,"0,0",Bellmunt del Priorat,Priorat,430234,280
43,Tarragona,024,Bellvei,2203,1132,1071,43024,Bellvei,1,,2,"1,8",3,"1,4",Bellvei,Baix Penedès,430249,2203
43,Tarragona,025,Benifallet,739,348,391,43025,Benifallet,0,,0,"0,0",0,"0,0",Benifallet,Baix Ebre,430252,739
43,Tarragona,026,Benissanet,1161,646,515,43026,Benissanet,0,,0,"0,0",0,"0,0",Benissanet,Ribera d'Ebre,430265,1161
43,Tarragona,027,"Bisbal de Falset, La",216,116,100,43027,La Bisbal de Falset,0,,0,"0,0",0,"0,0","Bisbal de Falset, la",Priorat,430271,216
43,Tarragona,028,"Bisbal del Penedès, La",3528,1862,1666,43028,La Bisbal del Penedès,5,,5,"2,7",10,"2,8","Bisbal del Penedès, la",Baix Penedès,430287,3528
43,Tarragona,029,Blancafort,389,198,191,43029,Blancafort,0,,0,"0,0",0,"0,0",Blancafort,Conca de Barberà,430290,389
43,Tarragona,030,Bonastre,688,357,331,43030,Bonastre,0,,0,"0,0",0,"0,0",Bonastre,Baix Penedès,430304,688
43,Tarragona,031,"Borges del Camp, Les",2037,1050,987,43031,Les Borges del Camp,0,,0,"0,0",0,"0,0","Borges del Camp, les",Baix Camp,430311,2037
43,Tarragona,032,Bot,573,295,278,43032,Bot,0,,0,"0,0",0,"0,0",Bot,Terra Alta,430326,573
43,Tarragona,033,Botarell,1068,549,519,43033,Botarell,1,,1,"1,8",2,"1,9",Botarell,Baix Camp,430332,1068
43,Tarragona,034,Bràfim,692,357,335,43034,Bràfim,2,,0,"0,0",2,"2,9",Bràfim,Alt Camp,430347,692
43,Tarragona,035,Cabacés,298,155,143,43035,Cabacés,0,,0,"0,0",0,"0,0",Cabacés,Priorat,430350,298
43,Tarragona,036,Cabra del Camp,1163,608,555,43036,Cabra del Camp,0,,0,"0,0",0,"0,0",Cabra del Camp,Alt Camp,430363,1163
43,Tarragona,037,Calafell,26538,13362,13176,43037,Calafell,25,,26,"1,9",51,"1,9",Calafell,Baix Penedès,430379,26538
43,Tarragona,903,Camarles,3224,1638,1586,43903,Camarles,1,,0,"0,0",1,"0,3",Camarles,Baix Ebre,439039,3224
43,Tarragona,038,Cambrils,33898,16553,17345,43038,Cambrils,44,,27,"1,6",71,"2,1",Cambrils,Baix Camp,430385,33898
43,Tarragona,907,"Canonja, La",5893,2892,3001,43907,La Canonja,3,,2,"0,7",5,"0,8","Canonja, la",Tarragonès,439076,5893
43,Tarragona,039,Capafonts,121,62,59,43039,Capafonts,0,,0,"0,0",0,"0,0",Capafonts,Baix Camp,430398,121
43,Tarragona,040,Capçanes,398,202,196,43040,Capçanes,0,,0,"0,0",0,"0,0",Capçanes,Priorat,430402,398
43,Tarragona,041,Caseres,259,129,130,43041,Caseres,1,,1,"7,8",2,"7,7",Caseres,Terra Alta,430419,259
43,Tarragona,042,Castellvell del Camp,2857,1438,1419,43042,Castellvell del Camp,1,,1,"0,7",2,"0,7",Castellvell del Camp,Baix Camp,430424,2857
43,Tarragona,043,"Catllar, El",4451,2309,2142,43043,El Catllar,3,,1,"0,4",4,"0,9","Catllar, el",Tarragonès,430430,4451
43,Tarragona,045,Colldejou,176,93,83,43045,Colldejou,0,,0,"0,0",0,"0,0",Colldejou,Baix Camp,430458,176
43,Tarragona,046,Conesa,103,54,49,43046,Conesa,0,,0,"0,0",0,"0,0",Conesa,Conca de Barberà,430461,103
43,Tarragona,047,Constantí,6540,3398,3142,43047,Constantí,5,,6,"1,8",11,"1,7",Constantí,Tarragonès,430477,6540
43,Tarragona,048,Corbera d'Ebre,1016,531,485,43048,Corbera d'Ebre,0,,0,"0,0",0,"0,0",Corbera d'Ebre,Terra Alta,430483,1016
43,Tarragona,049,Cornudella de Montsant,941,505,436,43049,Cornudella de Montsant,1,,1,"2,0",2,"2,1",Cornudella de Montsant,Priorat,430496,941
43,Tarragona,050,Creixell,3642,1845,1797,43050,Creixell,5,,2,"1,1",7,"1,9",Creixell,Tarragonès,430509,3642
43,Tarragona,051,Cunit,12952,6347,6605,43051,Cunit,17,,18,"2,8",35,"2,7",Cunit,Baix Penedès,430516,12952
43,Tarragona,901,Deltebre,11482,5788,5694,43901,Deltebre,0,,2,"0,3",2,"0,2",Deltebre,Baix Ebre,439018,11482
43,Tarragona,053,Duesaigües,245,140,105,43053,Duesaigües,0,,1,"7,1",1,"4,1",Duesaigües,Baix Camp,430537,245
43,Tarragona,054,"Espluga de Francolí, L'",3755,1824,1931,43054,L'Espluga de Francolí,1,,4,"2,2",5,"1,3","Espluga de Francolí, l'",Conca de Barberà,430542,3755
43,Tarragona,055,Falset,2834,1412,1422,43055,Falset,1,,1,"0,7",2,"0,7",Falset,Priorat,430555,2834
43,Tarragona,056,"Fatarella, La",941,458,483,43056,"La Fatarella,",0,,0,"0,0",0,"0,0","Fatarella, la",Terra Alta,430568,941
43,Tarragona,057,"Febró, La",40,25,15,43057,La Febró,0,,0,"0,0",0,"0,0","Febró, la",Baix Camp,430574,40
43,Tarragona,058,"Figuera, La",111,63,48,43058,"La Figuera,",0,,0,"0,0",0,"0,0","Figuera, la",Priorat,430580,111
43,Tarragona,059,Figuerola del Camp,320,159,161,43059,Figuerola del Camp,0,,0,"0,0",0,"0,0",Figuerola del Camp,Alt Camp,430593,320
43,Tarragona,060,Flix,3408,1717,1691,43060,Flix,1,,2,"1,2",3,"0,9",Flix,Ribera d'Ebre,430607,3408
43,Tarragona,061,Forès,43,25,18,43061,Forès,0,,0,"0,0",0,"0,0",Forès,Conca de Barberà,430614,43
43,Tarragona,062,Freginals,346,175,171,43062,Freginals,1,,0,"0,0",1,"2,9",Freginals,Montsià,430629,346
43,Tarragona,063,"Galera, La",731,375,356,43063,La Galera,0,,0,"0,0",0,"0,0","Galera, la",Montsià,430635,731
43,Tarragona,064,Gandesa,3064,1563,1501,43064,Gandesa,0,,0,"0,0",0,"0,0",Gandesa,Terra Alta,430640,3064
43,Tarragona,065,Garcia,527,264,263,43065,Garcia,0,,1,"3,8",1,"1,9",Garcia,Ribera d'Ebre,430653,527
43,Tarragona,066,"Garidells, Els",187,94,93,43066,Els Garidells,0,,0,"0,0",0,"0,0","Garidells, els",Alt Camp,430666,187
43,Tarragona,067,Ginestar,753,403,350,43067,Ginestar,1,,1,"2,5",2,"2,7",Ginestar,Ribera d'Ebre,430672,753
43,Tarragona,068,Godall,575,289,286,43068,Godall,0,,0,"0,0",0,"0,0",Godall,Montsià,430688,575
43,Tarragona,069,Gratallops,229,125,104,43069,Gratallops,0,,0,"0,0",0,"0,0",Gratallops,Priorat,430691,229
43,Tarragona,070,"Guiamets, Els",270,128,142,43070,Els Guiamets,0,,0,"0,0",0,"0,0","Guiamets, els",Priorat,430705,270
43,Tarragona,071,Horta de Sant Joan,1149,602,547,43071,Horta de Sant Joan,0,,1,"1,7",1,"0,9",Horta de Sant Joan,Terra Alta,430712,1149
43,Tarragona,072,"Lloar, El",107,58,49,43072,El Lloar,0,,0,"0,0",0,"0,0","Lloar, el",Priorat,430727,107
43,Tarragona,073,Llorac,100,52,48,43073,Llorac,0,,0,"0,0",0,"0,0",Llorac,Conca de Barberà,430733,100
43,Tarragona,074,Llorenç del Penedès,2393,1172,1221,43074,Llorenç del Penedès,5,,5,"4,3",10,"4,2",Llorenç del Penedès,Baix Penedès,430748,2393
43,Tarragona,076,Marçà,594,314,280,43076,Marçà,0,,0,"0,0",0,"0,0",Marçà,Priorat,430764,594
43,Tarragona,075,Margalef,97,59,38,43075,Margalef,0,,0,"0,0",0,"0,0",Margalef,Priorat,430751,97
43,Tarragona,077,Mas de Barberans,578,288,290,43077,Mas de Barberans,0,,0,"0,0",0,"0,0",Mas de Barberans,Montsià,430770,578
43,Tarragona,078,Masdenverge,1070,546,524,43078,Masdenverge,0,,0,"0,0",0,"0,0",Masdenverge,Montsià,430786,1070
43,Tarragona,079,Masllorenç,504,283,221,43079,Masllorenç,1,,0,"0,0",1,"2,0",Masllorenç,Baix Penedès,430799,504
43,Tarragona,080,"Masó, La",276,146,130,43080,La Masó,0,,1,"6,8",1,"3,6","Masó, la",Alt Camp,430803,276
43,Tarragona,081,Maspujols,827,426,401,43081,Maspujols,0,,0,"0,0",0,"0,0",Maspujols,Baix Camp,430810,827
43,Tarragona,082,"Masroig, El",497,270,227,43082,El Masroig,1,,0,"0,0",1,"2,0","Masroig, el",Priorat,430825,497
43,Tarragona,083,"Milà, El",178,85,93,43083,El Milà,0,,0,"0,0",0,"0,0","Milà, el",Alt Camp,430831,178
43,Tarragona,084,Miravet,691,369,322,43084,Miravet,0,,0,"0,0",0,"0,0",Miravet,Ribera d'Ebre,430846,691
43,Tarragona,085,"Molar, El",297,158,139,43085,El Molar,0,,0,"0,0",0,"0,0","Molar, el",Priorat,430859,297
43,Tarragona,086,Montblanc,7364,3737,3627,43086,Montblanc,7,,6,"1,6",13,"1,8",Montblanc,Conca de Barberà,430862,7364
43,Tarragona,088,Montbrió del Camp,2890,1485,1405,43088,Montbrió del Camp,2,,2,"1,3",4,"1,4",Montbrió del Camp,Baix Camp,430884,2890
43,Tarragona,089,Montferri,387,202,185,43089,Montferri,0,,1,"5,0",1,"2,6",Montferri,Alt Camp,430897,387
43,Tarragona,090,"Montmell, El",1512,808,704,43090,El Montmell,0,,0,"0,0",0,"0,0","Montmell, el",Baix Penedès,430901,1512
43,Tarragona,091,Mont-ral,162,94,68,43091,Mont-ral,0,,0,"0,0",0,"0,0",Mont-ral,Alt Camp,430918,162
43,Tarragona,092,Mont-roig del Camp,12136,6260,5876,43092,Mont-Roig del Camp,6,,10,"1,6",16,"1,3",Mont-roig del Camp,Baix Camp,430923,12136
43,Tarragona,093,Móra d'Ebre,5690,2845,2845,43093,Móra d'Ebre,5,,0,"0,0",5,"0,9",Móra d'Ebre,Ribera d'Ebre,430939,5690
43,Tarragona,094,Móra la Nova,3087,1541,1546,43094,Móra la Nova,0,,0,"0,0",0,"0,0",Móra la Nova,Ribera d'Ebre,430944,3087
43,Tarragona,095,"Morell, El",3704,1881,1823,43095,El Morell,5,,0,"0,0",5,"1,3","Morell, el",Tarragonès,430957,3704
43,Tarragona,096,"Morera de Montsant, La",152,85,67,43096,La Morera de Montsant,0,,0,"0,0",0,"0,0","Morera de Montsant, la",Priorat,430960,152
43,Tarragona,097,"Nou de Gaià, La",603,300,303,43097,La Nou de Gaià,0,,0,"0,0",0,"0,0","Nou de Gaià, la",Tarragonès,430976,603
43,Tarragona,098,Nulles,492,267,225,43098,Nulles,0,,0,"0,0",0,"0,0",Nulles,Alt Camp,430982,492
43,Tarragona,100,"Pallaresos, Els",4777,2404,2373,43100,Els Pallaresos,28,,12,"5,0",40,"8,4","Pallaresos, els",Tarragonès,431009,4777
43,Tarragona,099,"Palma d'Ebre, La",340,166,174,43099,La Palma d'Ebre,0,,1,"6,0",1,"2,9","Palma d'Ebre, la",Ribera d'Ebre,430995,340
43,Tarragona,101,Passanant i Belltall,163,95,68,43101,Passanant i Belltall,0,,0,"0,0",0,"0,0",Passanant i Belltall,Conca de Barberà,431016,163
43,Tarragona,102,Paüls,556,277,279,43102,Paüls,0,,0,"0,0",0,"0,0",Paüls,Baix Ebre,431021,556
43,Tarragona,103,Perafort,1261,654,607,43103,Perafort,2,,0,"0,0",2,"1,6",Perafort,Tarragonès,431037,1261
43,Tarragona,104,"Perelló, El",2770,1421,1349,43104,El Perelló,0,,0,"0,0",0,"0,0","Perelló, el",Baix Ebre,431042,2770
43,Tarragona,105,"Piles, Les",212,120,92,43105,"Piles, Les",0,,0,"0,0",0,"0,0","Piles, les",Conca de Barberà,431055,212
43,Tarragona,106,"Pinell de Brai, El",1017,516,501,43106,El Pinell de Brai,0,,0,"0,0",0,"0,0","Pinell de Brai, el",Terra Alta,431068,1017
43,Tarragona,107,Pira,493,261,232,43107,Pira,1,,0,"0,0",1,"2,0",Pira,Conca de Barberà,431074,493
43,Tarragona,108,"Pla de Santa Maria, El",2327,1215,1112,43108,El Pla de Santa Maria,2,,1,"0,8",3,"1,3","Pla de Santa Maria, el",Alt Camp,431080,2327
43,Tarragona,109,"Pobla de Mafumet, La",3904,1982,1922,43109,La Pobla de Mafumet,2,,0,"0,0",2,"0,5","Pobla de Mafumet, la",Tarragonès,431093,3904
43,Tarragona,110,"Pobla de Massaluca, La",318,181,137,43110,La Pobla de Massaluca,0,,0,"0,0",0,"0,0","Pobla de Massaluca, la",Terra Alta,431107,318
43,Tarragona,111,"Pobla de Montornès, La",2839,1486,1353,43111,La Pobla de Montornès,1,,2,"1,3",3,"1,1","Pobla de Montornès, la",Tarragonès,431114,2839
43,Tarragona,112,Poboleda,313,166,147,43112,Poboleda,0,,0,"0,0",0,"0,0",Poboleda,Priorat,431129,313
43,Tarragona,113,"Pont d'Armentera, El",505,258,247,43113,El Pont d'Armentera,1,,0,"0,0",1,"2,0","Pont d'Armentera, el",Alt Camp,431135,505
43,Tarragona,141,Pontils,117,66,51,43141,Pontils,0,,0,"0,0",0,"0,0",Pontils,Conca de Barberà,431418,117
43,Tarragona,114,Porrera,439,229,210,43114,Porrera,0,,0,"0,0",0,"0,0",Porrera,Priorat,431140,439
43,Tarragona,115,Pradell de la Teixeta,152,70,82,43115,Pradell de la Teixeta,0,,0,"0,0",0,"0,0",Pradell de la Teixeta,Priorat,431153,152
43,Tarragona,116,Prades,589,309,280,43116,Prades,0,,1,"3,2",1,"1,7",Prades,Baix Camp,431166,589
43,Tarragona,117,Prat de Comte,183,98,85,43117,Prat de Comte,0,,0,"0,0",0,"0,0",Prat de Comte,Terra Alta,431172,183
43,Tarragona,118,Pratdip,738,395,343,43118,Pratdip,0,,0,"0,0",0,"0,0",Pratdip,Baix Camp,431188,738
43,Tarragona,119,Puigpelat,1149,590,559,43119,Puigpelat,0,,0,"0,0",0,"0,0",Puigpelat,Alt Camp,431191,1149
43,Tarragona,120,Querol,507,285,222,43120,Querol,0,,0,"0,0",0,"0,0",Querol,Alt Camp,431205,507
43,Tarragona,121,Rasquera,781,384,397,43121,Rasquera,0,,0,"0,0",0,"0,0",Rasquera,Ribera d'Ebre,431212,781
43,Tarragona,122,Renau,157,82,75,43122,Renau,0,,0,"0,0",0,"0,0",Renau,Tarragonès,431227,157
43,Tarragona,123,Reus,104373,50415,53958,43123,Reus,192,,111,"2,2",303,"2,9",Reus,Baix Camp,431233,104373
43,Tarragona,124,"Riba, La",585,321,264,43124,La Riba,0,,0,"0,0",0,"0,0","Riba, la",Alt Camp,431248,585
43,Tarragona,125,Riba-roja d'Ebre,1126,593,533,43125,Riba-roja d'Ebre,0,,0,"0,0",0,"0,0",Riba-roja d'Ebre,Ribera d'Ebre,431251,1126
43,Tarragona,126,"Riera de Gaià, La",1744,867,877,43126,La Riera de Gaià,0,,2,"2,3",2,"1,1","Riera de Gaià, la",Tarragonès,431264,1744
43,Tarragona,127,Riudecanyes,1124,590,534,43127,Riudecanyes,0,,1,"1,7",1,"0,9",Riudecanyes,Baix Camp,431270,1124
43,Tarragona,128,Riudecols,1180,611,569,43128,Riudecols,1,,0,"0,0",1,"0,8",Riudecols,Baix Camp,431286,1180
43,Tarragona,129,Riudoms,6594,3380,3214,43129,Riudoms,9,,4,"1,2",13,"2,0",Riudoms,Baix Camp,431299,6594
43,Tarragona,130,Rocafort de Queralt,225,122,103,43130,Rocafort de Queralt,0,,0,"0,0",0,"0,0",Rocafort de Queralt,Conca de Barberà,431303,225
43,Tarragona,131,Roda de Berà,6567,3341,3226,43131,Roda de Berà,3,,7,"2,1",10,"1,5",Roda de Berà,Tarragonès,431310,6567
43,Tarragona,132,Rodonyà,490,262,228,43132,Rodonyà,1,,2,"7,6",3,"6,1",Rodonyà,Alt Camp,431325,490
43,Tarragona,133,Roquetes,7973,4126,3847,43133,Roquetes,2,,4,"1,0",6,"0,8",Roquetes,Baix Ebre,431331,7973
43,Tarragona,134,"Rourell, El",366,191,175,43134,El Rourell,0,,0,"0,0",0,"0,0","Rourell, el",Alt Camp,431346,366
43,Tarragona,135,Salomó,557,295,262,43135,Salomó,0,,0,"0,0",0,"0,0",Salomó,Tarragonès,431359,557
43,Tarragona,905,Salou,27476,14141,13335,43905,Salou,14,,22,"1,6",36,"1,3",Salou,Tarragonès,439057,27476
43,Tarragona,136,Sant Carles de la Ràpita,14789,7238,7551,43136,Sant Carles de la Ràpita,2,,3,"0,4",5,"0,3",Sant Carles de la Ràpita,Montsià,431362,14789
43,Tarragona,137,Sant Jaume dels Domenys,2622,1342,1280,43137,Sant Jaume dels Domenys,2,,2,"1,5",4,"1,5",Sant Jaume dels Domenys,Baix Penedès,431378,2622
43,Tarragona,902,Sant Jaume d'Enveja,3503,1765,1738,43902,Sant Jaume d'Enveja,0,,0,"0,0",0,"0,0",Sant Jaume d'Enveja,Montsià,439023,3503
43,Tarragona,138,Santa Bàrbara,3707,1881,1826,43138,Santa Bàrbara,1,,4,"2,1",5,"1,3",Santa Bàrbara,Montsià,431384,3707
43,Tarragona,139,Santa Coloma de Queralt,2673,1328,1345,43139,Santa Coloma de Queralt,2,,6,"4,5",8,"3,0",Santa Coloma de Queralt,Conca de Barberà,431397,2673
43,Tarragona,140,Santa Oliva,3320,1685,1635,43140,Santa Oliva,4,,7,"4,2",11,"3,3",Santa Oliva,Baix Penedès,431401,3320
43,Tarragona,142,Sarral,1548,789,759,43142,Sarral,1,,3,"3,8",4,"2,6",Sarral,Conca de Barberà,431423,1548
43,Tarragona,143,Savallà del Comtat,58,31,27,43143,Savallà del Comtat,0,,0,"0,0",0,"0,0",Savallà del Comtat,Conca de Barberà,431439,58
43,Tarragona,144,"Secuita, La",1687,851,836,43144,La Secuita,4,,0,"0,0",4,"2,4","Secuita, la",Tarragonès,431444,1687
43,Tarragona,145,"Selva del Camp, La",5652,2836,2816,43145,La Selva del Camp,9,,9,"3,2",18,"3,2","Selva del Camp, la",Baix Camp,431457,5652
43,Tarragona,146,Senan,48,33,15,43146,Senan,0,,0,"0,0",0,"0,0",Senan,Conca de Barberà,431460,48
43,Tarragona,044,"Sénia, La",5681,2844,2837,43044,La Sénia,0,,1,"0,4",1,"0,2","Sénia, la",Montsià,430445,5681
43,Tarragona,147,Solivella,633,333,300,43147,Solivella,2,,1,"3,0",3,"4,7",Solivella,Conca de Barberà,431476,633
43,Tarragona,148,Tarragona,134515,65505,69010,43148,Tarragona,125,,91,"1,4",216,"1,6",Tarragona,Tarragonès,431482,134515
43,Tarragona,149,Tivenys,899,458,441,43149,Tivenys,0,,0,"0,0",0,"0,0",Tivenys,Baix Ebre,431495,899
43,Tarragona,150,Tivissa,1602,799,803,43150,Tivissa,0,,0,"0,0",0,"0,0",Tivissa,Ribera d'Ebre,431508,1602
43,Tarragona,151,"Torre de Fontaubella, La",138,68,70,43151,La Torre de Fontaubella,0,,0,"0,0",0,"0,0","Torre de Fontaubella, la",Priorat,431515,138
43,Tarragona,152,"Torre de l'Espanyol, La",611,311,300,43152,La Torre de l'Espanyol,1,,0,"0,0",1,"1,6","Torre de l'Espanyol, la",Ribera d'Ebre,431520,611
43,Tarragona,153,Torredembarra,16184,7925,8259,43153,Torredembarra,12,,21,"2,6",33,"2,0",Torredembarra,Tarragonès,431536,16184
43,Tarragona,154,Torroja del Priorat,149,81,68,43154,Torroja del Priorat,0,,0,"0,0",0,"0,0",Torroja del Priorat,Priorat,431541,149
43,Tarragona,155,Tortosa,33372,16496,16876,43155,Tortosa,27,,14,"0,8",41,"1,2",Tortosa,Baix Ebre,431554,33372
43,Tarragona,156,Ulldecona,6300,3286,3014,43156,Ulldecona,1,,1,"0,3",2,"0,3",Ulldecona,Montsià,431567,6300
43,Tarragona,157,Ulldemolins,396,229,167,43157,Ulldemolins,0,,0,"0,0",0,"0,0",Ulldemolins,Priorat,431573,396
43,Tarragona,158,Vallclara,98,57,41,43158,Vallclara,0,,0,"0,0",0,"0,0",Vallclara,Conca de Barberà,431589,98
43,Tarragona,159,Vallfogona de Riucorb,91,55,36,43159,Vallfogona de Riucorb,0,,0,"0,0",0,"0,0",Vallfogona de Riucorb,Conca de Barberà,431592,91
43,Tarragona,160,Vallmoll,1756,890,866,43160,Vallmoll,0,,2,"2,2",2,"1,1",Vallmoll,Alt Camp,431606,1756
43,Tarragona,161,Valls,24359,12210,12149,43161,Valls,24,,21,"1,7",45,"1,8",Valls,Alt Camp,431613,24359
43,Tarragona,162,Vandellòs i l'Hospitalet de l'Infant,6482,3246,3236,43162,Vandellòs i l'Hospitalet de l'Infant,4,,8,"2,5",12,"1,9",Vandellòs i l'Hospitalet de l'Infant,Baix Camp,431628,6482
43,Tarragona,163,"Vendrell, El",37606,18631,18975,43163,El Vendrell,49,,47,"2,5",96,"2,6","Vendrell, el",Baix Penedès,431634,37606
43,Tarragona,164,Vespella de Gaià,410,232,178,43164,Vespella de Gaià,0,,0,"0,0",0,"0,0",Vespella de Gaià,Tarragonès,431649,410
43,Tarragona,165,Vilabella,736,378,358,43165,Vilabella,2,,2,"5,3",4,"5,4",Vilabella,Alt Camp,431652,736
43,Tarragona,175,Vilalba dels Arcs,625,318,307,43175,Vilalba dels Arcs,0,,0,"0,0",0,"0,0",Vilalba dels Arcs,Terra Alta,431750,625
43,Tarragona,166,Vilallonga del Camp,2389,1206,1183,43166,Vilallonga del Camp,4,,0,"0,0",4,"1,7",Vilallonga del Camp,Tarragonès,431665,2389
43,Tarragona,168,Vilanova de Prades,112,60,52,43168,Vilanova de Prades,0,,0,"0,0",0,"0,0",Vilanova de Prades,Conca de Barberà,431687,112
43,Tarragona,167,Vilanova d'Escornalbou,545,288,257,43167,Vilanova d'Escornalbou,0,,2,"6,9",2,"3,7",Vilanova d'Escornalbou,Baix Camp,431671,545
43,Tarragona,169,Vilaplana,574,302,272,43169,Vilaplana,1,,3,"9,9",4,"7,0",Vilaplana,Baix Camp,431690,574
43,Tarragona,170,Vila-rodona,1255,660,595,43170,Vila-Rodona,0,,2,"3,0",2,"1,6",Vila-rodona,Alt Camp,431704,1255
43,Tarragona,171,Vila-seca,22187,11113,11074,43171,Vila-Seca,18,,8,"0,7",26,"1,2",Vila-seca,Tarragonès,431711,22187
43,Tarragona,172,Vilaverd,452,240,212,43172,Vilaverd,0,,0,"0,0",0,"0,0",Vilaverd,Conca de Barberà,431726,452
43,Tarragona,173,"Vilella Alta, La",135,73,62,43173,La Vilella Alta,0,,0,"0,0",0,"0,0","Vilella Alta, la",Priorat,431732,135
43,Tarragona,174,"Vilella Baixa, La",202,113,89,43174,La Vilella Baixa,0,,0,"0,0",0,"0,0","Vilella Baixa, la",Priorat,431747,202
43,Tarragona,176,Vimbodí i Poblet,892,488,404,43176,Vimbodí i Poblet,0,,0,"0,0",0,"0,0",Vimbodí i Poblet,Conca de Barberà,431763,892
43,Tarragona,177,Vinebre,428,221,207,43177,Vinebre,0,,0,"0,0",0,"0,0",Vinebre,Ribera d'Ebre,431779,428
43,Tarragona,178,Vinyols i els Arcs,2056,1070,986,43178,Vinyols i  els Arcs,1,,1,"0,9",2,"1,0",Vinyols i els Arcs,Baix Camp,431785,2056
43,Tarragona,052,Xerta,1170,571,599,43052,Xerta,1,,0,"0,0",1,"0,9",Xerta,Baix Ebre,430521,1170