NOMBRE MUNICIPIO INE,POB19,HOMBRES,MUJERES,CODIGO INE 5,nom municipi GENCAT,MUJER,tasa 1000 hab mujer,HOMBRE,tasa 1000 hab hombre,Suma total,tasa 1000 hab total,nom municipi IDESCAT,comarca,codi municipi6,població total Idescat,Status,Status
Abrera,12489,6326,6163,08001,Abrera,58,"9,2",26,"4,1",84,"6,7",Abrera,Baix Llobregat,080018,12489,Matching,Matching
Aguilar de Segarra,288,155,133,08002,Aguilar de Segarra,1,"6,5",1,"6,5",2,"6,9",Aguilar de Segarra,Bages,080023,288,Matching,Matching
Alella,9801,4762,5039,08003,Alella,61,"12,8",38,"8,0",99,"10,1",Alella,Maresme,080039,9801,Matching,Matching
Alpens,266,144,122,08004,Alpens,0,"0,0",0,"0,0",0,"0,0",Alpens,Osona,080044,266,Matching,Non-matching
"Ametlla del Vallès, L'",8462,4277,4185,08005,L'Ametlla del Vallès,28,"6,5",22,"5,1",50,"5,9","Ametlla del Vallès, l'",Vallès Oriental,080057,8462,Matching,Matching
Arenys de Mar,15776,7683,8093,08006,Arenys de Mar,99,"12,9",54,"7,0",153,"9,7",Arenys de Mar,Maresme,080060,15776,Matching,Matching
Arenys de Munt,8931,4483,4448,08007,Arenys de Munt,47,"10,5",31,"6,9",78,"8,7",Arenys de Munt,Maresme,080076,8931,Matching,Matching
Argençola,217,110,107,08008,Argençola,3,"27,3",0,"0,0",3,"13,8",Argençola,Anoia,080082,217,Matching,Matching
Argentona,12452,6132,6320,08009,Argentona,59,"9,6",36,"5,9",95,"7,6",Argentona,Maresme,080095,12452,Matching,Matching
Artés,5698,2868,2830,08010,Artés,19,"6,6",13,"4,5",32,"5,6",Artés,Bages,080109,5698,Matching,Matching
Avià,2226,1121,1105,08011,Avià,6,"5,4",9,"8,0",15,"6,7",Avià,Berguedà,080116,2226,Matching,Matching
Avinyó,2275,1127,1148,08012,Avinyó,7,"6,2",4,"3,5",11,"4,8",Avinyó,Bages,080121,2275,Matching,Matching
Avinyonet del Penedès,1701,903,798,08013,Avinyonet del Penedès,6,"6,6",8,"8,9",14,"8,2",Avinyonet del Penedès,Alt Penedès,080137,1701,Matching,Matching
Aiguafreda,2504,1208,1296,08014,Aiguafreda,16,"13,2",7,"5,8",23,"9,2",Aiguafreda,Vallès Oriental,080142,2504,Matching,Matching
Badalona,220440,108509,111931,08015,Badalona,1482,"13,7",1167,"10,8",2649,"12,0",Badalona,Barcelonès,080155,220440,Matching,Matching
Bagà,2138,1064,1074,08016,Bagà,20,"18,8",18,"16,9",38,"17,8",Bagà,Berguedà,080168,2138,Matching,Matching
Balenyà,3821,1928,1893,08017,Balenyà,51,"26,5",13,"6,7",64,"16,7",Balenyà,Osona,080174,3821,Matching,Matching
Balsareny,3159,1562,1597,08018,Balsareny,13,"8,3",6,"3,8",19,"6,0",Balsareny,Bages,080180,3159,Matching,Matching
Barcelona,1636762,775619,861143,08019,Barcelona,9854,"12,7",7133,"9,2",16987,"10,4",Barcelona,Barcelonès,080193,1636762,Matching,Matching
Begues,7098,3528,3570,08020,Begues,29,"8,2",18,"5,1",47,"6,6",Begues,Baix Llobregat,080207,7098,Matching,Matching
Bellprat,64,41,23,08021,Bellprat,0,"0,0",0,"0,0",0,"0,0",Bellprat,Anoia,080214,64,Matching,Non-matching
Berga,16494,8166,8328,08022,Berga,86,"10,5",46,"5,6",132,"8,0",Berga,Berguedà,080229,16494,Matching,Matching
Bigues i Riells,9092,4645,4447,08023,Bigues i Riells,35,"7,5",25,"5,4",60,"6,6",Bigues i Riells,Vallès Oriental,080235,9092,Matching,Matching
Borredà,445,253,192,08024,Borredà,2,"7,9",2,"7,9",4,"9,0",Borredà,Berguedà,080240,445,Matching,Matching
"Bruc, El",2050,1107,943,08025,El Bruc,12,"10,8",4,"3,6",16,"7,8","Bruc, el",Anoia,080253,2050,Matching,Matching
"Brull, El",263,145,118,08026,El Brull,2,"13,8",1,"6,9",3,"11,4","Brull, el",Osona,080266,263,Matching,Matching
"Cabanyes, Les",964,488,476,08027,Les Cabanyes,9,"18,4",1,"2,0",10,"10,4","Cabanyes, les",Alt Penedès,080272,964,Matching,Matching
Cabrera d'Anoia,1410,769,641,08028,Cabrera d'Anoia,7,"9,1",6,"7,8",13,"9,2",Cabrera d'Anoia,Anoia,080288,1410,Matching,Matching
Cabrera de Mar,4680,2348,2332,08029,Cabrera de Mar,18,"7,7",12,"5,1",30,"6,4",Cabrera de Mar,Maresme,080291,4680,Matching,Matching
Cabrils,7439,3682,3757,08030,Cabrils,36,"9,8",24,"6,5",60,"8,1",Cabrils,Maresme,080305,7439,Matching,Matching
Calaf,3535,1775,1760,08031,Calaf,16,"9,0",10,"5,6",26,"7,4",Calaf,Anoia,080312,3535,Matching,Matching
Caldes d'Estrac,2982,1426,1556,08032,Caldes d'Estrac,27,"18,9",14,"9,8",41,"13,7",Caldes d'Estrac,Maresme,080327,2982,Matching,Matching
Caldes de Montbui,17554,8745,8809,08033,Caldes de Montbui,79,"9,0",53,"6,1",132,"7,5",Caldes de Montbui,Vallès Oriental,080333,17554,Matching,Matching
Calders,970,499,471,08034,Calders,6,"12,0",5,"10,0",11,"11,3",Calders,Moianès,080348,970,Matching,Matching
Calella,19069,9339,9730,08035,Calella,88,"9,4",55,"5,9",143,"7,5",Calella,Maresme,080351,19069,Matching,Matching
Calonge de Segarra,188,92,96,08036,Calonge de Segarra,0,"0,0",1,"10,9",1,"5,3",Calonge de Segarra,Anoia,080364,188,Matching,Matching
Calldetenes,2489,1259,1230,08037,Calldetenes,19,"15,1",19,"15,1",38,"15,3",Calldetenes,Osona,080370,2489,Matching,Matching
Callús,2140,1061,1079,08038,Callús,11,"10,4",4,"3,8",15,"7,0",Callús,Bages,080386,2140,Matching,Matching
Campins,529,277,252,08039,Campins,3,"10,8",1,"3,6",4,"7,6",Campins,Vallès Oriental,080399,529,Matching,Matching
Canet de Mar,14526,7068,7458,08040,Canet de Mar,73,"10,3",46,"6,5",119,"8,2",Canet de Mar,Maresme,080403,14526,Matching,Matching
Canovelles,16629,8613,8016,08041,Canovelles,41,"4,8",45,"5,2",86,"5,2",Canovelles,Vallès Oriental,080410,16629,Matching,Matching
Cànoves i Samalús,3117,1581,1536,08042,Cànoves i Samalús,11,"7,0",11,"7,0",22,"7,1",Cànoves i Samalús,Vallès Oriental,080425,3117,Matching,Matching
Canyelles,4647,2414,2233,08043,Canyelles,18,"7,5",11,"4,6",29,"6,2",Canyelles,Garraf,080431,4647,Matching,Matching
Capellades,5293,2636,2657,08044,Capellades,33,"12,5",32,"12,1",65,"12,3",Capellades,Anoia,080446,5293,Matching,Matching
Capolat,94,44,50,08045,Capolat,0,"0,0",0,"0,0",0,"0,0",Capolat,Berguedà,080459,94,Matching,Non-matching
Cardedeu,18357,8957,9400,08046,Cardedeu,82,"9,2",39,"4,4",121,"6,6",Cardedeu,Vallès Oriental,080462,18357,Matching,Matching
Cardona,4636,2273,2363,08047,Cardona,49,"21,6",23,"10,1",72,"15,5",Cardona,Bages,080478,4636,Matching,Matching
Carme,765,396,369,08048,Carme,9,"22,7",4,"10,1",13,"17,0",Carme,Anoia,080484,765,Matching,Matching
Casserres,1608,813,795,08049,Casserres,3,"3,7",4,"4,9",7,"4,4",Casserres,Berguedà,080497,1608,Matching,Matching
Castellar del Riu,169,94,75,08050,Castellar del Riu,0,"0,0",0,"0,0",0,"0,0",Castellar del Riu,Berguedà,080500,169,Matching,Non-matching
Castellar del Vallès,24187,11948,12239,08051,Castellar del Vallès,187,"15,7",91,"7,6",278,"11,5",Castellar del Vallès,Vallès Occidental,080517,24187,Matching,Matching
Castellar de n'Hug,159,85,74,08052,Castellar de n'Hug,0,"0,0",0,"0,0",0,"0,0",Castellar de n'Hug,Berguedà,080522,159,Matching,Non-matching
Castellbell i el Vilar,3647,1863,1784,08053,Castellbell i el Vilar,10,"5,4",2,"1,1",12,"3,3",Castellbell i el Vilar,Bages,080538,3647,Matching,Matching
Castellbisbal,12390,6238,6152,08054,Castellbisbal,43,"6,9",41,"6,6",84,"6,8",Castellbisbal,Vallès Occidental,080543,12390,Matching,Matching
Castellcir,752,392,360,08055,Castellcir,1,"2,6",1,"2,6",2,"2,7",Castellcir,Moianès,080556,752,Matching,Matching
Castelldefels,67004,33018,33986,08056,Castelldefels,271,"8,2",213,"6,5",484,"7,2",Castelldefels,Baix Llobregat,080569,67004,Matching,Matching
Castell de l'Areny,68,38,30,08057,Castell de l'Areny,0,"0,0",0,"0,0",0,"0,0",Castell de l'Areny,Berguedà,080575,68,Matching,Non-matching
Castellet i la Gornal,2292,1180,1112,08058,Castellet i la Gornal,6,"5,1",3,"2,5",9,"3,9",Castellet i la Gornal,Alt Penedès,080581,2292,Matching,Matching
Castellfollit del Boix,436,222,214,08059,Castellfollit del Boix,0,"0,0",2,"9,0",2,"4,6",Castellfollit del Boix,Bages,080594,436,Matching,Matching
Castellfollit de Riubregós,151,86,65,08060,Castellfollit de Riubregós,0,"0,0",0,"0,0",0,"0,0",Castellfollit de Riubregós,Anoia,080608,151,Matching,Non-matching
Castellgalí,2062,1062,1000,08061,Castellgalí,9,"8,5",9,"8,5",18,"8,7",Castellgalí,Bages,080615,2062,Matching,Matching
Castellnou de Bages,1397,732,665,08062,Castellnou de Bages,3,"4,1",2,"2,7",5,"3,6",Castellnou de Bages,Bages,080620,1397,Matching,Matching
Castellolí,619,302,317,08063,Castellolí,7,"23,2",6,"19,9",13,"21,0",Castellolí,Anoia,080636,619,Matching,Matching
Castellterçol,2463,1236,1227,08064,Castellterçol,11,"8,9",3,"2,4",14,"5,7",Castellterçol,Moianès,080641,2463,Matching,Matching
Castellví de la Marca,1535,771,764,08065,Castellví de la Marca,3,"3,9",0,"0,0",3,"2,0",Castellví de la Marca,Alt Penedès,080654,1535,Matching,Matching
Castellví de Rosanes,1884,931,953,08066,Catellví de Rosanes,4,"4,3",3,"3,2",7,"3,7",Castellví de Rosanes,Baix Llobregat,080667,1884,Matching,Matching
Centelles,7404,3630,3774,08067,Centelles,32,"8,8",23,"6,3",55,"7,4",Centelles,Osona,080673,7404,Matching,Matching
Cervelló,9054,4529,4525,08068,Cervelló,27,"6,0",32,"7,1",59,"6,5",Cervelló,Baix Llobregat,080689,9054,Matching,Matching
Collbató,4466,2320,2146,08069,Collbató,21,"9,1",18,"7,8",39,"8,7",Collbató,Baix Llobregat,080692,4466,Matching,Matching
Collsuspina,342,174,168,08070,Collsuspina,3,"17,2",0,"0,0",3,"8,8",Collsuspina,Moianès,080706,342,Matching,Matching
Copons,310,152,158,08071,Copons,2,"13,2",3,"19,7",5,"16,1",Copons,Anoia,080713,310,Matching,Matching
Corbera de Llobregat,14822,7449,7373,08072,Corbera de Llobregat,77,"10,3",27,"3,6",104,"7,0",Corbera de Llobregat,Baix Llobregat,080728,14822,Matching,Matching
Cornellà de Llobregat,88592,42945,45647,08073,Cornellà de Llobregat,459,"10,7",235,"5,5",694,"7,8",Cornellà de Llobregat,Baix Llobregat,080734,88592,Matching,Matching
Cubelles,15329,7687,7642,08074,Cubelles,44,"5,7",30,"3,9",74,"4,8",Cubelles,Garraf,080749,15329,Matching,Matching
Dosrius,5481,2780,2701,08075,Dosrius,26,"9,4",13,"4,7",39,"7,1",Dosrius,Maresme,080752,5481,Matching,Matching
Esparreguera,22251,11249,11002,08076,Esparreguera,54,"4,8",48,"4,3",102,"4,6",Esparreguera,Baix Llobregat,080765,22251,Matching,Matching
Esplugues de Llobregat,46680,22300,24380,08077,Esplugues de Llobregat,256,"11,5",132,"5,9",388,"8,3",Esplugues de Llobregat,Baix Llobregat,080771,46680,Matching,Matching
"Espunyola, L'",254,126,128,08078,L'Espunyola,0,"0,0",0,"0,0",0,"0,0","Espunyola, l'",Berguedà,080787,254,Matching,Non-matching
"Estany, L'",406,205,201,08079,L'Estany,2,"9,8",0,"0,0",2,"4,9","Estany, l'",Moianès,080790,406,Matching,Matching
Fígols,42,25,17,08080,Fígols,0,"0,0",0,"0,0",0,"0,0",Fígols,Berguedà,080804,42,Matching,Non-matching
Fogars de Montclús,470,245,225,08081,Fogars de Montclús,2,"8,2",0,"0,0",2,"4,3",Fogars de Montclús,Vallès Oriental,080811,470,Matching,Matching
Fogars de la Selva,1451,748,703,08082,Fogars de Tordera,6,"8,0",1,"1,3",7,"4,8",Fogars de la Selva,Selva,080826,1451,Matching,Matching
Folgueroles,2267,1159,1108,08083,Folgueroles,11,"9,5",2,"1,7",13,"5,7",Folgueroles,Osona,080832,2267,Matching,Matching
Fonollosa,1453,750,703,08084,Fonollosa,8,"10,7",2,"2,7",10,"6,9",Fonollosa,Bages,080847,1453,Matching,Matching
Font-rubí,1327,688,639,08085,Font-Rubí,10,"14,5",4,"5,8",14,"10,6",Font-rubí,Alt Penedès,080850,1327,Matching,Matching
"Franqueses del Vallès, Les",20092,10210,9882,08086,Les Franqueses del Vallès,92,"9,0",53,"5,2",145,"7,2","Franqueses del Vallès, les",Vallès Oriental,080863,20092,Matching,Matching
Gallifa,172,95,77,08087,Gallifa,0,"0,0",2,"21,1",2,"11,6",Gallifa,Vallès Occidental,080879,172,Matching,Matching
"Garriga, La",16514,7987,8527,08088,La Garriga,53,"6,6",68,"8,5",121,"7,3","Garriga, la",Vallès Oriental,080885,16514,Matching,Matching
Gavà,46771,22876,23895,08089,Gavà,322,"14,1",223,"9,7",545,"11,7",Gavà,Baix Llobregat,080898,46771,Matching,Matching
Gaià,175,97,78,08090,Gaià,0,"0,0",0,"0,0",0,"0,0",Gaià,Bages,080902,175,Matching,Non-matching
Gelida,7533,3778,3755,08091,Gelida,26,"6,9",15,"4,0",41,"5,4",Gelida,Alt Penedès,080919,7533,Matching,Matching
Gironella,4826,2384,2442,08092,Gironella,22,"9,2",12,"5,0",34,"7,0",Gironella,Berguedà,080924,4826,Matching,Matching
Gisclareny,25,15,10,08093,Gisclareny,0,"0,0",0,"0,0",0,"0,0",Gisclareny,Berguedà,080930,25,Matching,Non-matching
"Granada, La",2157,1092,1065,08094,La Granada,10,"9,2",12,"11,0",22,"10,2","Granada, la",Alt Penedès,080945,2157,Matching,Matching
Granera,69,53,16,08095,Granera,0,"0,0",0,"0,0",0,"0,0",Granera,Moianès,080958,69,Matching,Non-matching
Granollers,61275,30199,31076,08096,Granollers,297,"9,8",216,"7,2",513,"8,4",Granollers,Vallès Oriental,080961,61275,Matching,Matching
Gualba,1500,769,731,08097,Gualba,11,"14,3",4,"5,2",15,"10,0",Gualba,Vallès Oriental,080977,1500,Matching,Matching
Sant Salvador de Guardiola,3179,1630,1549,08098,Sant Salvador de Guardiola,10,"6,1",14,"8,6",24,"7,5",Sant Salvador de Guardiola,Bages,080983,3179,Matching,Matching
Guardiola de Berguedà,908,464,444,08099,Guardiola de Berguedà,4,"8,6",3,"6,5",7,"7,7",Guardiola de Berguedà,Berguedà,080996,908,Matching,Matching
Gurb,2681,1386,1295,08100,Gurb,20,"14,4",6,"4,3",26,"9,7",Gurb,Osona,081000,2681,Matching,Matching
"Hospitalet de Llobregat, L'",264923,127981,136942,08101,L'Hospitalet de Llobregat,1627,"12,7",1172,"9,2",2799,"10,6","Hospitalet de Llobregat, l'",Barcelonès,081017,264923,Matching,Matching
Igualada,39967,19636,20331,08102,Igualada,650,"33,1",333,"17,0",983,"24,6",Igualada,Anoia,081022,39967,Matching,Matching
Jorba,835,424,411,08103,Jorba,11,"25,9",4,"9,4",15,"18,0",Jorba,Anoia,081038,835,Matching,Matching
"Llacuna, La",870,475,395,08104,La Llacuna,5,"10,5",11,"23,2",16,"18,4","Llacuna, la",Anoia,081043,870,Matching,Matching
"Llagosta, La",13480,6675,6805,08105,La Llagosta,51,"7,6",54,"8,1",105,"7,8","Llagosta, la",Vallès Oriental,081056,13480,Matching,Matching
Llinars del Vallès,9938,4946,4992,08106,Llinars del Vallès,57,"11,5",42,"8,5",99,"10,0",Llinars del Vallès,Vallès Oriental,081069,9938,Matching,Matching
Lliçà d'Amunt,15256,7819,7437,08107,Lliçà d'Amunt,77,"9,8",29,"3,7",106,"6,9",Lliçà d'Amunt,Vallès Oriental,081075,15256,Matching,Matching
Lliçà de Vall,6542,3335,3207,08108,Lliçà de Vall,35,"10,5",21,"6,3",56,"8,6",Lliçà de Vall,Vallès Oriental,081081,6542,Matching,Matching
Lluçà,273,134,139,08109,Lluçà,2,"14,9",0,"0,0",2,"7,3",Lluçà,Osona,081094,273,Matching,Matching
Malgrat de Mar,18579,9280,9299,08110,Malgrat de Mar,83,"8,9",51,"5,5",134,"7,2",Malgrat de Mar,Maresme,081108,18579,Matching,Matching
Malla,273,139,134,08111,Malla,1,"7,2",0,"0,0",1,"3,7",Malla,Osona,081115,273,Matching,Matching
Manlleu,20573,10314,10259,08112,Manlleu,117,"11,3",79,"7,7",196,"9,5",Manlleu,Osona,081120,20573,Matching,Matching
Manresa,77714,38066,39648,08113,Manresa,375,"9,9",233,"6,1",608,"7,8",Manresa,Bages,081136,77714,Matching,Matching
Martorell,28189,14329,13860,08114,Martorell,160,"11,2",85,"5,9",245,"8,7",Martorell,Baix Llobregat,081141,28189,Matching,Matching
Martorelles,4801,2422,2379,08115,Martorelles,25,"10,3",13,"5,4",38,"7,9",Martorelles,Vallès Oriental,081154,4801,Matching,Matching
"Masies de Roda, Les",700,355,345,08116,Les Masies de Roda,2,"5,6",1,"2,8",3,"4,3","Masies de Roda, les",Osona,081167,700,Matching,Matching
"Masies de Voltregà, Les",3141,1551,1590,08117,Les Masies de Voltregà,15,"9,7",8,"5,2",23,"7,3","Masies de Voltregà, les",Osona,081173,3141,Matching,Matching
"Masnou, El",23515,11357,12158,08118,El Masnou,129,"11,4",76,"6,7",205,"8,7","Masnou, el",Maresme,081189,23515,Matching,Matching
Masquefa,9211,4641,4570,08119,Masquefa,35,"7,5",20,"4,3",55,"6,0",Masquefa,Anoia,081192,9211,Matching,Matching
Matadepera,9326,4657,4669,08120,Matadepera,58,"12,5",33,"7,1",91,"9,8",Matadepera,Vallès Occidental,081206,9326,Matching,Matching
Mataró,128265,63637,64628,08121,Mataró,622,"9,8",399,"6,3",1021,"8,0",Mataró,Maresme,081213,128265,Matching,Matching
Mediona,2322,1159,1163,08122,Mediona,104,"89,7",31,"26,7",135,"58,1",Mediona,Alt Penedès,081228,2322,Matching,Matching
Molins de Rei,25868,12612,13256,08123,Molins de Rei,88,"7,0",44,"3,5",132,"5,1",Molins de Rei,Baix Llobregat,081234,25868,Matching,Matching
Mollet del Vallès,51318,25222,26096,08124,Mollet del Vallès,435,"17,2",235,"9,3",670,"13,1",Mollet del Vallès,Vallès Oriental,081249,51318,Matching,Matching
Montcada i Reixac,36239,17901,18338,08125,Montcada i Reixac,196,"10,9",111,"6,2",307,"8,5",Montcada i Reixac,Vallès Occidental,081252,36239,Matching,Matching
Montgat,12041,5938,6103,08126,Montgat,77,"13,0",53,"8,9",130,"10,8",Montgat,Maresme,081265,12041,Matching,Matching
Monistrol de Montserrat,3034,1551,1483,08127,Monistrol de Montserrat,11,"7,1",8,"5,2",19,"6,3",Monistrol de Montserrat,Bages,081271,3034,Matching,Matching
Monistrol de Calders,682,357,325,08128,Monistrol de Calders,1,"2,8",2,"5,6",3,"4,4",Monistrol de Calders,Moianès,081287,682,Matching,Matching
Muntanyola,634,321,313,08129,Muntanyola,3,"9,3",1,"3,1",4,"6,3",Muntanyola,Osona,081290,634,Matching,Matching
Montclar,136,71,65,08130,Montclar,0,"0,0",0,"0,0",0,"0,0",Montclar,Berguedà,081304,136,Matching,Non-matching
Montesquiu,998,501,497,08131,Montesquiu,9,"18,0",5,"10,0",14,"14,0",Montesquiu,Osona,081311,998,Matching,Matching
Montmajor,464,231,233,08132,Montmajor,0,"0,0",1,"4,3",1,"2,2",Montmajor,Berguedà,081326,464,Matching,Matching
Montmaneu,150,83,67,08133,Montmaneu,0,"0,0",0,"0,0",0,"0,0",Montmaneu,Anoia,081332,150,Matching,Non-matching
Figaró-Montmany,1114,547,567,08134,Figaró-Montmany,16,"29,3",6,"11,0",22,"19,7",Figaró-Montmany,Vallès Oriental,081347,1114,Matching,Matching
Montmeló,8755,4275,4480,08135,Montmeló,45,"10,5",26,"6,1",71,"8,1",Montmeló,Vallès Oriental,081350,8755,Matching,Matching
Montornès del Vallès,16393,8251,8142,08136,Montornès del Vallès,76,"9,2",99,"12,0",175,"10,7",Montornès del Vallès,Vallès Oriental,081363,16393,Matching,Matching
Montseny,342,179,163,08137,Montseny,2,"11,2",1,"5,6",3,"8,8",Montseny,Vallès Oriental,081379,342,Matching,Matching
Moià,6267,3190,3077,08138,Moià,27,"8,5",13,"4,1",40,"6,4",Moià,Moianès,081385,6267,Matching,Matching
Mura,224,122,102,08139,Mura,1,"8,2",0,"0,0",1,"4,5",Mura,Bages,081398,224,Matching,Matching
Navarcles,5977,2914,3063,08140,Navarcles,34,"11,7",22,"7,5",56,"9,4",Navarcles,Bages,081402,5977,Matching,Matching
Navàs,6020,2998,3022,08141,Navàs,28,"9,3",22,"7,3",50,"8,3",Navàs,Bages,081419,6020,Matching,Matching
"Nou de Berguedà, La",161,83,78,08142,La Nou de Berguedà,0,"0,0",0,"0,0",0,"0,0","Nou de Berguedà, la",Berguedà,081424,161,Matching,Non-matching
Òdena,3643,1848,1795,08143,Òdena,34,"18,4",18,"9,7",52,"14,3",Òdena,Anoia,081430,3643,Matching,Matching
Olvan,854,416,438,08144,Olvan,1,"2,4",3,"7,2",4,"4,7",Olvan,Berguedà,081445,854,Matching,Matching
Olèrdola,3692,1900,1792,08145,Olèrdola,9,"4,7",10,"5,3",19,"5,1",Olèrdola,Alt Penedès,081458,3692,Matching,Matching
Olesa de Bonesvalls,1810,949,861,08146,Olesa de Bonesvalls,9,"9,5",2,"2,1",11,"6,1",Olesa de Bonesvalls,Alt Penedès,081461,1810,Matching,Matching
Olesa de Montserrat,23904,11913,11991,08147,Olesa de Montserrat,131,"11,0",66,"5,5",197,"8,2",Olesa de Montserrat,Baix Llobregat,081477,23904,Matching,Matching
Olivella,3799,1985,1814,08148,Olivella,1,"0,5",7,"3,5",8,"2,1",Olivella,Garraf,081483,3799,Matching,Matching
Olost,1198,588,610,08149,Olost,3,"5,1",2,"3,4",5,"4,2",Olost,Osona,081496,1198,Matching,Matching
Orís,315,159,156,08150,Orís,3,"18,9",1,"6,3",4,"12,7",Orís,Osona,081509,315,Matching,Matching
Oristà,541,274,267,08151,Oristà,1,"3,6",1,"3,6",2,"3,7",Oristà,Osona,081516,541,Matching,Matching
Orpí,147,80,67,08152,Orpí,0,"0,0",0,"0,0",0,"0,0",Orpí,Anoia,081521,147,Matching,Non-matching
Òrrius,739,381,358,08153,Òrrius,0,"0,0",0,"0,0",0,"0,0",Òrrius,Maresme,081537,739,Matching,Non-matching
Pacs del Penedès,922,469,453,08154,Pacs del Penedès,3,"6,4",4,"8,5",7,"7,6",Pacs del Penedès,Alt Penedès,081542,922,Matching,Matching
Palafolls,9405,4690,4715,08155,Palafolls,32,"6,8",9,"1,9",41,"4,4",Palafolls,Maresme,081555,9405,Matching,Matching
Palau-solità i Plegamans,14771,7246,7525,08156,Palau-Solità i Plegamans,57,"7,9",43,"5,9",100,"6,8",Palau-solità i Plegamans,Vallès Occidental,081568,14771,Matching,Matching
Pallejà,11508,5728,5780,08157,Pallejà,80,"14,0",34,"5,9",114,"9,9",Pallejà,Baix Llobregat,081574,11508,Matching,Matching
"Papiol, El",4145,2052,2093,08158,El Papiol,13,"6,3",5,"2,4",18,"4,3","Papiol, el",Baix Llobregat,081580,4145,Matching,Matching
Parets del Vallès,19082,9541,9541,08159,Parets del Vallès,129,"13,5",69,"7,2",198,"10,4",Parets del Vallès,Vallès Oriental,081593,19082,Matching,Matching
Perafita,395,202,193,08160,Perafita,0,"0,0",0,"0,0",0,"0,0",Perafita,Osona,081607,395,Matching,Non-matching
Piera,15603,7976,7627,08161,Piera,87,"10,9",74,"9,3",161,"10,3",Piera,Anoia,081614,15603,Matching,Matching
"Hostalets de Pierola, Els",2973,1518,1455,08162,Els Hostalets de Pierola,22,"14,5",13,"8,6",35,"11,8","Hostalets de Pierola, els",Anoia,081629,2973,Matching,Matching
Pineda de Mar,27272,13588,13684,08163,Pineda de Mar,91,"6,7",61,"4,5",152,"5,6",Pineda de Mar,Maresme,081635,27272,Matching,Matching
"Pla del Penedès, El",1256,636,620,08164,El Pla del Penedès,2,"3,1",3,"4,7",5,"4,0","Pla del Penedès, el",Alt Penedès,081640,1256,Matching,Matching
"Pobla de Claramunt, La",2193,1104,1089,08165,La Pobla de Claramunt,20,"18,1",19,"17,2",39,"17,8","Pobla de Claramunt, la",Anoia,081653,2193,Matching,Matching
"Pobla de Lillet, La",1095,528,567,08166,La Pobla de Lillet,2,"3,8",1,"1,9",3,"2,7","Pobla de Lillet, la",Berguedà,081666,1095,Matching,Matching
Polinyà,8479,4295,4184,08167,Polinyà,37,"8,6",17,"4,0",54,"6,4",Polinyà,Vallès Occidental,081672,8479,Matching,Matching
Pontons,532,289,243,08168,Pontons,0,"0,0",0,"0,0",0,"0,0",Pontons,Alt Penedès,081688,532,Matching,Non-matching
"Prat de Llobregat, El",64599,31621,32978,08169,El Prat de Llobregat,447,"14,1",353,"11,2",800,"12,4","Prat de Llobregat, el",Baix Llobregat,081691,64599,Matching,Matching
"Prats de Rei, Els",532,283,249,08170,Els Prats de Rei,2,"7,1",1,"3,5",3,"5,6","Prats de Rei, els",Anoia,081705,532,Matching,Matching
Prats de Lluçanès,2569,1280,1289,08171,Prats de Lluçanès,13,"10,2",9,"7,0",22,"8,6",Prats de Lluçanès,Osona,081712,2569,Matching,Matching
Premià de Mar,28119,13704,14415,08172,Premià de Mar,131,"9,6",96,"7,0",227,"8,1",Premià de Mar,Maresme,081727,28119,Matching,Matching
Puigdàlber,526,256,270,08174,Puigdàlber,3,"11,7",2,"7,8",5,"9,5",Puigdàlber,Alt Penedès,081748,526,Matching,Matching
Puig-reig,4178,2086,2092,08175,Puig-Reig,19,"9,1",10,"4,8",29,"6,9",Puig-reig,Berguedà,081751,4178,Matching,Matching
Pujalt,210,119,91,08176,Pujalt,0,"0,0",0,"0,0",0,"0,0",Pujalt,Anoia,081764,210,Matching,Non-matching
"Quar, La",53,29,24,08177,La Quar,0,"0,0",0,"0,0",0,"0,0","Quar, la",Berguedà,081770,53,Matching,Non-matching
Rajadell,548,275,273,08178,Rajadell,0,"0,0",1,"3,6",1,"1,8",Rajadell,Bages,081786,548,Matching,Matching
Rellinars,780,403,377,08179,Rellinars,4,"9,9",0,"0,0",4,"5,1",Rellinars,Vallès Occidental,081799,780,Matching,Matching
Ripollet,38665,19080,19585,08180,Ripollet,195,"10,2",140,"7,3",335,"8,7",Ripollet,Vallès Occidental,081803,38665,Matching,Matching
"Roca del Vallès, La",10650,5319,5331,08181,La Roca del Vallès,35,"6,6",31,"5,8",66,"6,2","Roca del Vallès, la",Vallès Oriental,081810,10650,Matching,Matching
"Pont de Vilomara i Rocafort, El",3830,1969,1861,08182,El Pont de Vilomara i Rocafort,13,"6,6",10,"5,1",23,"6,0","Pont de Vilomara i Rocafort, el",Bages,081825,3830,Matching,Matching
Roda de Ter,6301,3118,3183,08183,Roda de Ter,39,"12,5",16,"5,1",55,"8,7",Roda de Ter,Osona,081831,6301,Matching,Matching
Rubí,77464,38358,39106,08184,Rubí,360,"9,4",231,"6,0",591,"7,6",Rubí,Vallès Occidental,081846,77464,Matching,Matching
Rubió,239,133,106,08185,Rubió,0,"0,0",0,"0,0",0,"0,0",Rubió,Anoia,081859,239,Matching,Non-matching
Sabadell,213644,103847,109797,08187,Sabadell,1665,"16,0",1148,"11,1",2813,"13,2",Sabadell,Vallès Occidental,081878,213644,Matching,Matching
Sagàs,148,80,68,08188,Sagàs,0,"0,0",0,"0,0",0,"0,0",Sagàs,Berguedà,081884,148,Matching,Non-matching
Sant Pere Sallavinera,152,82,70,08189,Sant Pere Sallavinera,0,"0,0",0,"0,0",0,"0,0",Sant Pere Sallavinera,Anoia,081897,152,Matching,Non-matching
Saldes,274,159,115,08190,Saldes,1,"6,3",0,"0,0",1,"3,6",Saldes,Berguedà,081901,274,Matching,Matching
Sallent,6658,3211,3447,08191,Sallent,29,"9,0",12,"3,7",41,"6,2",Sallent,Bages,081918,6658,Matching,Matching
Santpedor,7554,3755,3799,08192,Santpedor,51,"13,6",19,"5,1",70,"9,3",Santpedor,Bages,081923,7554,Matching,Matching
Sant Iscle de Vallalta,1332,687,645,08193,Sant Iscle de Vallalta,3,"4,4",3,"4,4",6,"4,5",Sant Iscle de Vallalta,Maresme,081939,1332,Matching,Matching
Sant Adrià de Besòs,37097,18251,18846,08194,Sant Adrià del Besòs,247,"13,5",161,"8,8",408,"11,0",Sant Adrià de Besòs,Barcelonès,081944,37097,Matching,Matching
Sant Agustí de Lluçanès,85,42,43,08195,Sant Agustí de Lluçanès,0,"0,0",0,"0,0",0,"0,0",Sant Agustí de Lluçanès,Osona,081957,85,Matching,Non-matching
Sant Andreu de la Barca,27558,13679,13879,08196,Sant Andreu de la Barca,113,"8,3",59,"4,3",172,"6,2",Sant Andreu de la Barca,Baix Llobregat,081960,27558,Matching,Matching
Sant Andreu de Llavaneres,10968,5424,5544,08197,Sant Andreu de Llavaneres,58,"10,7",41,"7,6",99,"9,0",Sant Andreu de Llavaneres,Maresme,081976,10968,Matching,Matching
Sant Antoni de Vilamajor,6135,3031,3104,08198,Sant Antoni de Vilamajor,39,"12,9",23,"7,6",62,"10,1",Sant Antoni de Vilamajor,Vallès Oriental,081982,6135,Matching,Matching
Sant Bartomeu del Grau,858,460,398,08199,Sant Bartomeu del Grau,1,"2,2",3,"6,5",4,"4,7",Sant Bartomeu del Grau,Osona,081995,858,Matching,Matching
Sant Boi de Llobregat,83605,40877,42728,08200,Sant Boi de Llobregat,561,"13,7",409,"10,0",970,"11,6",Sant Boi de Llobregat,Baix Llobregat,082009,83605,Matching,Matching
Sant Boi de Lluçanès,541,269,272,08201,Sant Boi de Lluçanès,2,"7,4",4,"14,9",6,"11,1",Sant Boi de Lluçanès,Osona,082016,541,Matching,Matching
Sant Celoni,17904,8939,8965,08202,Sant Celoni,103,"11,5",53,"5,9",156,"8,7",Sant Celoni,Vallès Oriental,082021,17904,Matching,Matching
Sant Cebrià de Vallalta,3385,1764,1621,08203,Sant Cebrià de Vallalta,7,"4,0",2,"1,1",9,"2,7",Sant Cebrià de Vallalta,Maresme,082037,3385,Matching,Matching
Sant Climent de Llobregat,4129,2075,2054,08204,Sant Climent de Llobregat,28,"13,5",26,"12,5",54,"13,1",Sant Climent de Llobregat,Baix Llobregat,082042,4129,Matching,Matching
Sant Cugat del Vallès,91006,44197,46809,08205,Sant Cugat del Vallès,382,"8,6",277,"6,3",659,"7,2",Sant Cugat del Vallès,Vallès Occidental,082055,91006,Matching,Matching
Sant Cugat Sesgarrigues,1007,488,519,08206,Sant Cugat Sesgarrigues,2,"4,1",2,"4,1",4,"4,0",Sant Cugat Sesgarrigues,Alt Penedès,082068,1007,Matching,Matching
Sant Esteve de Palautordera,2820,1391,1429,08207,Sant Esteve de Palautordera,17,"12,2",10,"7,2",27,"9,6",Sant Esteve de Palautordera,Vallès Oriental,082074,2820,Matching,Matching
Sant Esteve Sesrovires,7612,3835,3777,08208,Sant Esteve Sesrovires,63,"16,4",43,"11,2",106,"13,9",Sant Esteve Sesrovires,Baix Llobregat,082080,7612,Matching,Matching
Sant Fost de Campsentelles,8737,4352,4385,08209,Sant Fost de Campsentelles,56,"12,9",40,"9,2",96,"11,0",Sant Fost de Campsentelles,Vallès Oriental,082093,8737,Matching,Matching
Sant Feliu de Codines,6259,3168,3091,08210,Sant Feliu de Codines,18,"5,7",13,"4,1",31,"5,0",Sant Feliu de Codines,Vallès Oriental,082107,6259,Matching,Matching
Sant Feliu de Llobregat,44860,21767,23093,08211,Sant Feliu de Llobregat,192,"8,8",107,"4,9",299,"6,7",Sant Feliu de Llobregat,Baix Llobregat,082114,44860,Matching,Matching
Sant Feliu Sasserra,602,312,290,08212,Sant Feliu Sasserra,2,"6,4",0,"0,0",2,"3,3",Sant Feliu Sasserra,Bages,082129,602,Matching,Matching
Sant Fruitós de Bages,8703,4295,4408,08213,Sant Fruitós de Bages,62,"14,4",25,"5,8",87,"10,0",Sant Fruitós de Bages,Bages,082135,8703,Matching,Matching
Vilassar de Dalt,9043,4462,4581,08214,Vilassar de Dalt,41,"9,2",17,"3,8",58,"6,4",Vilassar de Dalt,Maresme,082140,9043,Matching,Matching
Sant Hipòlit de Voltregà,3484,1729,1755,08215,Sant Hipòlit de Voltregà,29,"16,8",14,"8,1",43,"12,3",Sant Hipòlit de Voltregà,Osona,082153,3484,Matching,Matching
Sant Jaume de Frontanyà,30,18,12,08216,Sant Jaume de Frontanyà,0,"0,0",0,"0,0",0,"0,0",Sant Jaume de Frontanyà,Berguedà,082166,30,Matching,Non-matching
Sant Joan Despí,34123,16585,17538,08217,Sant Joan Despí,179,"10,8",92,"5,5",271,"7,9",Sant Joan Despí,Baix Llobregat,082172,34123,Matching,Matching
Sant Joan de Vilatorrada,10936,5490,5446,08218,Sant Joan de Vilatorrada,72,"13,1",39,"7,1",111,"10,1",Sant Joan de Vilatorrada,Bages,082188,10936,Matching,Matching
Vilassar de Mar,20837,10068,10769,08219,Vilassar de Mar,94,"9,3",60,"6,0",154,"7,4",Vilassar de Mar,Maresme,082191,20837,Matching,Matching
Sant Julià de Vilatorta,3114,1539,1575,08220,Sant Julià de Vilatorta,26,"16,9",20,"13,0",46,"14,8",Sant Julià de Vilatorta,Osona,082205,3114,Matching,Matching
Sant Just Desvern,17805,8544,9261,08221,Sant Just Desvern,100,"11,7",55,"6,4",155,"8,7",Sant Just Desvern,Baix Llobregat,082212,17805,Matching,Matching
Sant Llorenç d'Hortons,2413,1226,1187,08222,Sant Llorenç d'Hortons,9,"7,3",10,"8,2",19,"7,9",Sant Llorenç d'Hortons,Alt Penedès,082227,2413,Matching,Matching
Sant Llorenç Savall,2373,1197,1176,08223,Sant Llorenç Savall,76,"63,5",14,"11,7",90,"37,9",Sant Llorenç Savall,Vallès Occidental,082233,2373,Matching,Matching
Sant Martí de Centelles,1167,600,567,08224,Sant Martí de Centelles,3,"5,0",3,"5,0",6,"5,1",Sant Martí de Centelles,Osona,082248,1167,Matching,Matching
Sant Martí d'Albars,112,56,56,08225,Sant Martí d'Albars,0,"0,0",0,"0,0",0,"0,0",Sant Martí d'Albars,Osona,082251,112,Matching,Non-matching
Sant Martí de Tous,1235,637,598,08226,Sant Martí de Tous,14,"22,0",12,"18,8",26,"21,1",Sant Martí de Tous,Anoia,082264,1235,Matching,Matching
Sant Martí Sarroca,3264,1608,1656,08227,Sant Martí Sarroca,16,"10,0",8,"5,0",24,"7,4",Sant Martí Sarroca,Alt Penedès,082270,3264,Matching,Matching
Sant Martí Sesgueioles,343,176,167,08228,Sant Martí Sesgueioles,2,"11,4",0,"0,0",2,"5,8",Sant Martí Sesgueioles,Anoia,082286,343,Matching,Matching
Sant Mateu de Bages,603,302,301,08229,Sant Mateu de Bages,3,"9,9",2,"6,6",5,"8,3",Sant Mateu de Bages,Bages,082299,603,Matching,Matching
Premià de Dalt,10448,5207,5241,08230,Premià de Dalt,41,"7,9",35,"6,7",76,"7,3",Premià de Dalt,Maresme,082303,10448,Matching,Matching
Sant Pere de Ribes,30719,15268,15451,08231,Sant Pere de Ribes,140,"9,2",84,"5,5",224,"7,3",Sant Pere de Ribes,Garraf,082310,30719,Matching,Matching
Sant Pere de Riudebitlles,2368,1181,1187,08232,Sant Pere de Riudebitlles,11,"9,3",2,"1,7",13,"5,5",Sant Pere de Riudebitlles,Alt Penedès,082325,2368,Matching,Matching
Sant Pere de Torelló,2419,1242,1177,08233,Sant Pere de Torelló,9,"7,2",5,"4,0",14,"5,8",Sant Pere de Torelló,Osona,082331,2419,Matching,Matching
Sant Pere de Vilamajor,4472,2239,2233,08234,Sant Pere de Vilamajor,24,"10,7",11,"4,9",35,"7,8",Sant Pere de Vilamajor,Vallès Oriental,082346,4472,Matching,Matching
Sant Pol de Mar,5299,2604,2695,08235,Sant Pol de Mar,18,"6,9",18,"6,9",36,"6,8",Sant Pol de Mar,Maresme,082359,5299,Matching,Matching
Sant Quintí de Mediona,2254,1154,1100,08236,Sant Quintí de Mediona,9,"7,8",9,"7,8",18,"8,0",Sant Quintí de Mediona,Alt Penedès,082362,2254,Matching,Matching
Sant Quirze de Besora,2167,1054,1113,08237,Sant Quirze de Besora,10,"9,5",5,"4,7",15,"6,9",Sant Quirze de Besora,Osona,082378,2167,Matching,Matching
Sant Quirze del Vallès,20141,9865,10276,08238,Sant Quirze del Vallès,213,"21,6",113,"11,5",326,"16,2",Sant Quirze del Vallès,Vallès Occidental,082384,20141,Matching,Matching
Sant Quirze Safaja,627,336,291,08239,Sant Quirze  Safaja,0,"0,0",2,"6,0",2,"3,2",Sant Quirze Safaja,Moianès,082397,627,Matching,Matching
Sant Sadurní d'Anoia,12887,6348,6539,08240,Sant Sadurní d'Anoia,39,"6,1",25,"3,9",64,"5,0",Sant Sadurní d'Anoia,Alt Penedès,082401,12887,Matching,Matching
Sant Sadurní d'Osormort,78,47,31,08241,Sant Sadurní d'Osormort,0,"0,0",0,"0,0",0,"0,0",Sant Sadurní d'Osormort,Osona,082418,78,Matching,Non-matching
Marganell,266,131,135,08242,Marganell,1,"7,6",1,"7,6",2,"7,5",Marganell,Bages,082423,266,Matching,Matching
Santa Cecília de Voltregà,187,99,88,08243,Santa Cecília de Voltregà,0,"0,0",0,"0,0",0,"0,0",Santa Cecília de Voltregà,Osona,082439,187,Matching,Non-matching
Santa Coloma de Cervelló,8218,4026,4192,08244,Santa Coloma de Cervelló,65,"16,1",22,"5,5",87,"10,6",Santa Coloma de Cervelló,Baix Llobregat,082444,8218,Matching,Matching
Santa Coloma de Gramenet,119215,58895,60320,08245,Santa Coloma de Gramenet,876,"14,9",571,"9,7",1447,"12,1",Santa Coloma de Gramenet,Barcelonès,082457,119215,Matching,Matching
Santa Eugènia de Berga,2248,1142,1106,08246,Santa Eugènia de Berga,13,"11,4",8,"7,0",21,"9,3",Santa Eugènia de Berga,Osona,082460,2248,Matching,Matching
Santa Eulàlia de Riuprimer,1345,686,659,08247,Santa Eulàlia de Riuprimer,13,"19,0",11,"16,0",24,"17,8",Santa Eulàlia de Riuprimer,Osona,082476,1345,Matching,Matching
Santa Eulàlia de Ronçana,7288,3639,3649,08248,Santa Eulàlia de Ronçana,20,"5,5",15,"4,1",35,"4,8",Santa Eulàlia de Ronçana,Vallès Oriental,082482,7288,Matching,Matching
Santa Fe del Penedès,374,185,189,08249,Santa Fe del Penedès,1,"5,4",1,"5,4",2,"5,3",Santa Fe del Penedès,Alt Penedès,082495,374,Matching,Matching
Santa Margarida de Montbui,9980,4993,4987,08250,Santa Margarida de Montbui,112,"22,4",93,"18,6",205,"20,5",Santa Margarida de Montbui,Anoia,082508,9980,Matching,Matching
Santa Margarida i els Monjos,7611,3856,3755,08251,Santa Margarida i els Monjos,26,"6,7",20,"5,2",46,"6,0",Santa Margarida i els Monjos,Alt Penedès,082515,7611,Matching,Matching
Barberà del Vallès,33091,16300,16791,08252,Barberà del Vallès,226,"13,9",146,"9,0",372,"11,2",Barberà del Vallès,Vallès Occidental,082520,33091,Matching,Matching
Santa Maria de Besora,150,78,72,08253,Santa Maria de Besora,0,"0,0",0,"0,0",0,"0,0",Santa Maria de Besora,Osona,082536,150,Matching,Non-matching
"Esquirol, L'",2181,1105,1076,08254,L'Esquirol,19,"17,2",12,"10,9",31,"14,2","Esquirol, l'",Osona,082541,2181,Matching,Matching
Santa Maria de Merlès,184,89,95,08255,Santa Maria de Merlès,0,"0,0",0,"0,0",0,"0,0",Santa Maria de Merlès,Berguedà,082554,184,Matching,Non-matching
Santa Maria de Martorelles,893,449,444,08256,Santa Maria de Martorelles,4,"8,9",2,"4,5",6,"6,7",Santa Maria de Martorelles,Vallès Oriental,082567,893,Matching,Matching
Santa Maria de Miralles,126,68,58,08257,Santa Maria de Miralles,0,"0,0",0,"0,0",0,"0,0",Santa Maria de Miralles,Anoia,082573,126,Matching,Non-matching
Santa Maria d'Oló,1025,521,504,08258,Santa Maria d'Oló,2,"3,8",2,"3,8",4,"3,9",Santa Maria d'Oló,Moianès,082589,1025,Matching,Matching
Santa Maria de Palautordera,9423,4760,4663,08259,Santa Maria de Palautordera,34,"7,1",22,"4,6",56,"5,9",Santa Maria de Palautordera,Vallès Oriental,082592,9423,Matching,Matching
Santa Perpètua de Mogoda,25799,12958,12841,08260,Santa Perpétua de Mogoda,129,"10,0",89,"6,9",218,"8,4",Santa Perpètua de Mogoda,Vallès Occidental,082606,25799,Matching,Matching
Santa Susanna,3446,1721,1725,08261,Santa Susanna,15,"8,7",5,"2,9",20,"5,8",Santa Susanna,Maresme,082613,3446,Matching,Matching
Sant Vicenç de Castellet,9523,4760,4763,08262,Sant Vicenç de Castellet,30,"6,3",19,"4,0",49,"5,1",Sant Vicenç de Castellet,Bages,082628,9523,Matching,Matching
Sant Vicenç dels Horts,28117,13959,14158,08263,Sant Vicenç dels Horts,145,"10,4",98,"7,0",243,"8,6",Sant Vicenç dels Horts,Baix Llobregat,082634,28117,Matching,Matching
Sant Vicenç de Montalt,6407,3199,3208,08264,Sant Vicenç de Montalt,22,"6,9",22,"6,9",44,"6,9",Sant Vicenç de Montalt,Maresme,082649,6407,Matching,Matching
Sant Vicenç de Torelló,2058,1019,1039,08265,Sant Vicenç de Torelló,8,"7,9",4,"3,9",12,"5,8",Sant Vicenç de Torelló,Osona,082652,2058,Matching,Matching
Cerdanyola del Vallès,57403,28038,29365,08266,Cerdanyola del Vallès,345,"12,3",275,"9,8",620,"10,8",Cerdanyola del Vallès,Vallès Occidental,082665,57403,Matching,Matching
Sentmenat,9078,4611,4467,08267,Sentmenat,50,"10,8",16,"3,5",66,"7,3",Sentmenat,Vallès Occidental,082671,9078,Matching,Matching
Cercs,1145,577,568,08268,Cercs,4,"6,9",4,"6,9",8,"7,0",Cercs,Berguedà,082687,1145,Matching,Matching
Seva,3519,1784,1735,08269,Seva,13,"7,3",4,"2,2",17,"4,8",Seva,Osona,082690,3519,Matching,Matching
Sitges,29307,14708,14599,08270,Sitges,96,"6,5",75,"5,1",171,"5,8",Sitges,Garraf,082704,29307,Matching,Matching
Sobremunt,79,36,43,08271,Sobremunt,0,"0,0",0,"0,0",0,"0,0",Sobremunt,Osona,082711,79,Matching,Non-matching
Sora,209,117,92,08272,Sora,0,"0,0",0,"0,0",0,"0,0",Sora,Osona,082726,209,Matching,Non-matching
Subirats,3044,1577,1467,08273,Subirats,14,"8,9",8,"5,1",22,"7,2",Subirats,Alt Penedès,082732,3044,Matching,Matching
Súria,5942,2897,3045,08274,Súria,23,"7,9",15,"5,2",38,"6,4",Súria,Bages,082747,5942,Matching,Matching
Tavèrnoles,316,159,157,08275,Tavèrnoles,1,"6,3",0,"0,0",1,"3,2",Tavèrnoles,Osona,082750,316,Matching,Matching
Tagamanent,323,169,154,08276,Tagamanent,0,"0,0",0,"0,0",0,"0,0",Tagamanent,Vallès Oriental,082763,323,Matching,Non-matching
Talamanca,206,115,91,08277,Talamanca,0,"0,0",0,"0,0",0,"0,0",Talamanca,Bages,082779,206,Matching,Non-matching
Taradell,6489,3238,3251,08278,Taradell,42,"13,0",32,"9,9",74,"11,4",Taradell,Osona,082785,6489,Matching,Matching
Terrassa,220556,108469,112087,08279,Terrassa,1251,"11,5",871,"8,0",2122,"9,6",Terrassa,Vallès Occidental,082798,220556,Matching,Matching
Tavertet,111,57,54,08280,Tavertet,0,"0,0",0,"0,0",0,"0,0",Tavertet,Osona,082802,111,Matching,Non-matching
Teià,6397,3134,3263,08281,Teià,36,"11,5",34,"10,8",70,"10,9",Teià,Maresme,082819,6397,Matching,Matching
Tiana,8840,4233,4607,08282,Tiana,57,"13,5",41,"9,7",98,"11,1",Tiana,Maresme,082824,8840,Matching,Matching
Tona,8241,4099,4142,08283,Tona,65,"15,9",30,"7,3",95,"11,5",Tona,Osona,082830,8241,Matching,Matching
Tordera,17216,8722,8494,08284,Tordera,48,"5,5",29,"3,3",77,"4,5",Tordera,Maresme,082845,17216,Matching,Matching
Torelló,14347,7137,7210,08285,Torelló,56,"7,8",45,"6,3",101,"7,0",Torelló,Osona,082858,14347,Matching,Matching
"Torre de Claramunt, La",3714,1923,1791,08286,La Torre de Claramunt,30,"15,6",21,"10,9",51,"13,7","Torre de Claramunt, la",Anoia,082861,3714,Matching,Matching
Torrelavit,1419,723,696,08287,Torrelavit,4,"5,5",6,"8,3",10,"7,0",Torrelavit,Alt Penedès,082877,1419,Matching,Matching
Torrelles de Foix,2348,1267,1081,08288,Torrelles de Foix,5,"3,9",6,"4,7",11,"4,7",Torrelles de Foix,Alt Penedès,082883,2348,Matching,Matching
Torrelles de Llobregat,6041,3003,3038,08289,Torrelles de Llobregat,25,"8,3",13,"4,3",38,"6,3",Torrelles de Llobregat,Baix Llobregat,082896,6041,Matching,Matching
Ullastrell,2093,1052,1041,08290,Ullastrell,17,"16,2",9,"8,6",26,"12,4",Ullastrell,Vallès Occidental,082900,2093,Matching,Matching
Vacarisses,6688,3436,3252,08291,Vacarisses,26,"7,6",12,"3,5",38,"5,7",Vacarisses,Vallès Occidental,082917,6688,Matching,Matching
Vallbona d'Anoia,1373,719,654,08292,Vallbona d'Anoia,14,"19,5",8,"11,1",22,"16,0",Vallbona d'Anoia,Anoia,082922,1373,Matching,Matching
Vallcebre,250,142,108,08293,Vallcebre,0,"0,0",0,"0,0",0,"0,0",Vallcebre,Berguedà,082938,250,Matching,Non-matching
Vallgorguina,2891,1451,1440,08294,Vallgorguina,14,"9,6",10,"6,9",24,"8,3",Vallgorguina,Vallès Oriental,082943,2891,Matching,Matching
Vallirana,15006,7523,7483,08295,Vallirana,58,"7,7",40,"5,3",98,"6,5",Vallirana,Baix Llobregat,082956,15006,Matching,Matching
Vallromanes,2579,1328,1251,08296,Vallromanes,13,"9,8",5,"3,8",18,"7,0",Vallromanes,Vallès Oriental,082969,2579,Matching,Matching
Veciana,182,99,83,08297,Veciana,0,"0,0",0,"0,0",0,"0,0",Veciana,Anoia,082975,182,Matching,Non-matching
Vic,46214,23306,22908,08298,Vic,289,"12,4",192,"8,2",481,"10,4",Vic,Osona,082981,46214,Matching,Matching
Vilada,416,217,199,08299,Vilada,1,"4,6",0,"0,0",1,"2,4",Vilada,Berguedà,082994,416,Matching,Matching
Viladecavalls,7512,3724,3788,08300,Viladecavalls,45,"12,1",21,"5,6",66,"8,8",Viladecavalls,Vallès Occidental,083008,7512,Matching,Matching
Viladecans,66611,32930,33681,08301,Viladecans,595,"18,1",346,"10,5",941,"14,1",Viladecans,Baix Llobregat,083015,66611,Matching,Matching
Vilanova del Camí,12458,6227,6231,08302,Vilanova del Camí,143,"23,0",81,"13,0",224,"18,0",Vilanova del Camí,Anoia,083020,12458,Matching,Matching
Vilanova de Sau,299,142,157,08303,Vilanova de Sau,1,"7,0",1,"7,0",2,"6,7",Vilanova de Sau,Osona,083036,299,Matching,Matching
Vilobí del Penedès,1107,569,538,08304,Vilobí del Penedès,3,"5,3",0,"0,0",3,"2,7",Vilobí del Penedès,Alt Penedès,083041,1107,Matching,Matching
Vilafranca del Penedès,39746,19341,20405,08305,Vilafranca del Penedès,313,"16,2",120,"6,2",433,"10,9",Vilafranca del Penedès,Alt Penedès,083054,39746,Matching,Matching
Vilalba Sasserra,716,357,359,08306,Vilalba Sasserra,19,"53,2",12,"33,6",31,"43,3",Vilalba Sasserra,Vallès Oriental,083067,716,Matching,Matching
Vilanova i la Geltrú,67086,32456,34630,08307,Vilanova i la Geltrú,288,"8,9",189,"5,8",477,"7,1",Vilanova i la Geltrú,Garraf,083073,67086,Matching,Matching
Viver i Serrateix,168,87,81,08308,Viver i Serrateix,0,"0,0",0,"0,0",0,"0,0",Viver i Serrateix,Berguedà,083089,168,Matching,Non-matching
Rupit i Pruit,279,139,140,08901,Rupit i Pruit,2,"14,4",0,"0,0",2,"7,2",Rupit i Pruit,Osona,089019,279,Matching,Matching
Vilanova del Vallès,5432,2760,2672,08902,Vilanova del Vallès,38,"13,8",16,"5,8",54,"9,9",Vilanova del Vallès,Vallès Oriental,089024,5432,Matching,Matching
Sant Julià de Cerdanyola,228,125,103,08903,Sant Julià de Cerdanyola,2,"16,0",2,"16,0",4,"17,5",Sant Julià de Cerdanyola,Berguedà,089030,228,Matching,Matching
Badia del Vallès,13380,6567,6813,08904,Badia del Vallès,72,"11,0",46,"7,0",118,"8,8",Badia del Vallès,Vallès Occidental,089045,13380,Matching,Matching
"Palma de Cervelló, La",2954,1460,1494,08905,La Palma de Cervelló,4,"2,7",2,"1,4",6,"2,0","Palma de Cervelló, la",Baix Llobregat,089058,2954,Matching,Matching
Agullana,831,411,420,17001,Agullana,0,"0,0",3,"7,3",3,"3,6",Agullana,Alt Empordà,170010,831,Matching,Matching
Aiguaviva,756,383,373,17002,Aiguaviva,3,"7,8",2,"5,2",5,"6,6",Aiguaviva,Gironès,170025,756,Matching,Matching
Albanyà,157,80,77,17003,Albanyà,0,"0,0",0,"0,0",0,"0,0",Albanyà,Alt Empordà,170031,157,Matching,Non-matching
Albons,776,401,375,17004,Albons,2,"5,0",0,"0,0",2,"2,6",Albons,Baix Empordà,170046,776,Matching,Matching
"Far d'Empordà, El",599,305,294,17005,El Far d'Empordà,2,"6,6",3,"9,8",5,"8,3","Far d'Empordà, el",Alt Empordà,170059,599,Matching,Matching
Alp,1580,828,752,17006,Alp,0,"0,0",6,"7,2",6,"3,8",Alp,Cerdanya,170062,1580,Matching,Matching
Amer,2298,1122,1176,17007,Amer,7,"6,2",5,"4,5",12,"5,2",Amer,Selva,170078,2298,Matching,Matching
Anglès,5599,2780,2819,17008,Anglès,18,"6,5",10,"3,6",28,"5,0",Anglès,Selva,170084,5599,Matching,Matching
Arbúcies,6556,3390,3166,17009,Arbúcies,24,"7,1",14,"4,1",38,"5,8",Arbúcies,Selva,170097,6556,Matching,Matching
Argelaguer,397,205,192,17010,Argelaguer,0,"0,0",0,"0,0",0,"0,0",Argelaguer,Garrotxa,170101,397,Matching,Non-matching
"Armentera, L'",930,461,469,17011,L'Armentera,3,"6,5",4,"8,7",7,"7,5","Armentera, l'",Alt Empordà,170118,930,Matching,Matching
Avinyonet de Puigventós,1610,796,814,17012,Avinyonet de Puigventós,7,"8,8",5,"6,3",12,"7,5",Avinyonet de Puigventós,Alt Empordà,170123,1610,Matching,Matching
Begur,3925,1964,1961,17013,Begur,9,"4,6",4,"2,0",13,"3,3",Begur,Baix Empordà,170139,3925,Matching,Matching
"Vajol, La",89,48,41,17014,La Vajol,0,"0,0",0,"0,0",0,"0,0","Vajol, la",Alt Empordà,170144,89,Matching,Non-matching
Banyoles,19826,9873,9953,17015,Banyoles,82,"8,3",69,"7,0",151,"7,6",Banyoles,Pla de l'Estany,170157,19826,Matching,Matching
Bàscara,1004,520,484,17016,Bàscara,1,"1,9",0,"0,0",1,"1,0",Bàscara,Alt Empordà,170160,1004,Matching,Matching
Bellcaire d'Empordà,693,336,357,17018,Bellcaire d'Empordà,1,"3,0",1,"3,0",2,"2,9",Bellcaire d'Empordà,Baix Empordà,170182,693,Matching,Matching
Besalú,2492,1170,1322,17019,Besalú,11,"9,4",5,"4,3",16,"6,4",Besalú,Garrotxa,170195,2492,Matching,Matching
Bescanó,4960,2505,2455,17020,Bescanó,20,"8,0",19,"7,6",39,"7,9",Bescanó,Gironès,170209,4960,Matching,Matching
Beuda,190,100,90,17021,Beuda,0,"0,0",0,"0,0",0,"0,0",Beuda,Garrotxa,170216,190,Matching,Non-matching
"Bisbal d'Empordà, La",10974,5446,5528,17022,La Bisbal d'Empordà,31,"5,7",21,"3,9",52,"4,7","Bisbal d'Empordà, la",Baix Empordà,170221,10974,Matching,Matching
Blanes,39028,19356,19672,17023,Blanes,191,"9,9",124,"6,4",315,"8,1",Blanes,Selva,170237,39028,Matching,Matching
Bolvir,369,191,178,17024,Bolvir,0,"0,0",0,"0,0",0,"0,0",Bolvir,Cerdanya,170242,369,Matching,Non-matching
Bordils,1779,887,892,17025,Bordils,2,"2,3",7,"7,9",9,"5,1",Bordils,Gironès,170255,1779,Matching,Matching
Borrassà,714,374,340,17026,Borrassà,5,"13,4",1,"2,7",6,"8,4",Borrassà,Alt Empordà,170268,714,Matching,Matching
Breda,3740,1836,1904,17027,Breda,9,"4,9",10,"5,4",19,"5,1",Breda,Selva,170274,3740,Matching,Matching
Brunyola i Sant Martí Sapresa,383,195,188,17028,Brunyola,1,"5,1",0,"0,0",1,"2,6",Brunyola i Sant Martí Sapresa,Selva,170280,383,Matching,Matching
Boadella i les Escaules,252,130,122,17029,Boadella d'Empordà,1,"7,7",0,"0,0",1,"4,0",Boadella i les Escaules,Alt Empordà,170293,252,Matching,Matching
Cabanes,948,500,448,17030,Cabanes,2,"4,0",0,"0,0",2,"2,1",Cabanes,Alt Empordà,170307,948,Matching,Matching
Cabanelles,279,154,125,17031,Cabanelles,0,"0,0",1,"6,5",1,"3,6",Cabanelles,Alt Empordà,170314,279,Matching,Matching
Cadaqués,2712,1322,1390,17032,Cadaqués,9,"6,8",5,"3,8",14,"5,2",Cadaqués,Alt Empordà,170329,2712,Matching,Matching
Caldes de Malavella,7641,3828,3813,17033,Caldes de Malavella,32,"8,4",21,"5,5",53,"6,9",Caldes de Malavella,Selva,170335,7641,Matching,Matching
Calonge i Sant Antoni,11092,5571,5521,17034,Calonge i Sant Antoni,58,"10,4",24,"4,3",82,"7,4",Calonge i Sant Antoni,Baix Empordà,170340,11092,Matching,Matching
Camós,693,341,352,17035,Camós,4,"11,7",0,"0,0",4,"5,8",Camós,Pla de l'Estany,170353,693,Matching,Matching
Campdevànol,3223,1566,1657,17036,Campdevànol,10,"6,4",4,"2,6",14,"4,3",Campdevànol,Ripollès,170366,3223,Matching,Matching
Campelles,139,71,68,17037,Campelles,0,"0,0",0,"0,0",0,"0,0",Campelles,Ripollès,170372,139,Matching,Non-matching
Campllong,547,272,275,17038,Campllong,1,"3,7",1,"3,7",2,"3,7",Campllong,Gironès,170388,547,Matching,Matching
Camprodon,2281,1117,1164,17039,Camprodon,5,"4,5",5,"4,5",10,"4,4",Camprodon,Ripollès,170391,2281,Matching,Matching
Canet d'Adri,723,371,352,17040,Canet d'Adri,3,"8,1",3,"8,1",6,"8,3",Canet d'Adri,Gironès,170405,723,Matching,Matching
Cantallops,313,153,160,17041,Cantallops,0,"0,0",0,"0,0",0,"0,0",Cantallops,Alt Empordà,170412,313,Matching,Non-matching
Capmany,613,307,306,17042,Capmany,6,"19,5",5,"16,3",11,"17,9",Capmany,Alt Empordà,170427,613,Matching,Matching
Queralbs,191,104,87,17043,Queralbs,0,"0,0",0,"0,0",0,"0,0",Queralbs,Ripollès,170433,191,Matching,Non-matching
Cassà de la Selva,10380,5301,5079,17044,Cassà de la Selva,40,"7,5",24,"4,5",64,"6,2",Cassà de la Selva,Gironès,170448,10380,Matching,Matching
Castellfollit de la Roca,961,493,468,17046,Castellfollit de la Roca,3,"6,1",0,"0,0",3,"3,1",Castellfollit de la Roca,Garrotxa,170464,961,Matching,Matching
Castelló d'Empúries,10906,5508,5398,17047,Castelló d'Empúries,24,"4,4",16,"2,9",40,"3,7",Castelló d'Empúries,Alt Empordà,170470,10906,Matching,Matching
Castell-Platja d'Aro,10860,5357,5503,17048,Castell-Platja d'Aro,25,"4,7",11,"2,1",36,"3,3",Castell-Platja d'Aro,Baix Empordà,170486,10860,Matching,Matching
Celrà,5452,2722,2730,17049,Celrà,21,"7,7",14,"5,1",35,"6,4",Celrà,Gironès,170499,5452,Matching,Matching
Cervià de Ter,968,492,476,17050,Cervià de Ter,7,"14,2",3,"6,1",10,"10,3",Cervià de Ter,Gironès,170502,968,Matching,Matching
Cistella,282,138,144,17051,Cistella,2,"14,5",2,"14,5",4,"14,2",Cistella,Alt Empordà,170519,282,Matching,Matching
Siurana,168,84,84,17052,Siurana,0,"0,0",0,"0,0",0,"0,0",Siurana,Alt Empordà,170524,168,Matching,Non-matching
Colera,448,223,225,17054,Colera,1,"4,5",1,"4,5",2,"4,5",Colera,Alt Empordà,170545,448,Matching,Matching
Colomers,176,87,89,17055,Colomers,0,"0,0",0,"0,0",0,"0,0",Colomers,Baix Empordà,170558,176,Matching,Non-matching
Cornellà del Terri,2364,1197,1167,17056,Cornellà del Terri,11,"9,2",5,"4,2",16,"6,8",Cornellà del Terri,Pla de l'Estany,170561,2364,Matching,Matching
Corçà,1267,646,621,17057,Corçà,3,"4,6",3,"4,6",6,"4,7",Corçà,Baix Empordà,170577,1267,Matching,Matching
Crespià,246,127,119,17058,Crespià,0,"0,0",1,"7,9",1,"4,1",Crespià,Pla de l'Estany,170583,246,Matching,Matching
Darnius,546,273,273,17060,Darnius,2,"7,3",1,"3,7",3,"5,5",Darnius,Alt Empordà,170600,546,Matching,Matching
Das,253,131,122,17061,Das,0,"0,0",0,"0,0",0,"0,0",Das,Cerdanya,170617,253,Matching,Non-matching
"Escala, L'",10339,5267,5072,17062,L'Escala,23,"4,4",16,"3,0",39,"3,8","Escala, l'",Alt Empordà,170622,10339,Matching,Matching
Espinelves,215,110,105,17063,Espinelves,0,"0,0",1,"9,1",1,"4,7",Espinelves,Osona,170638,215,Matching,Matching
Espolla,416,203,213,17064,Espolla,1,"4,9",1,"4,9",2,"4,8",Espolla,Alt Empordà,170643,416,Matching,Matching
Esponellà,438,224,214,17065,Esponellà,2,"8,9",4,"17,9",6,"13,7",Esponellà,Pla de l'Estany,170656,438,Matching,Matching
Figueres,46654,23092,23562,17066,Figueres,221,"9,6",123,"5,3",344,"7,4",Figueres,Alt Empordà,170669,46654,Matching,Matching
Flaçà,1093,528,565,17067,Flaçà,3,"5,7",1,"1,9",4,"3,7",Flaçà,Gironès,170675,1093,Matching,Matching
Foixà,297,150,147,17068,Foixà,0,"0,0",0,"0,0",0,"0,0",Foixà,Baix Empordà,170681,297,Matching,Non-matching
Fontanals de Cerdanya,444,220,224,17069,Fontanals de Cerdanya,0,"0,0",1,"4,5",1,"2,3",Fontanals de Cerdanya,Cerdanya,170694,444,Matching,Matching
Fontanilles,139,80,59,17070,Fontanilles,0,"0,0",0,"0,0",0,"0,0",Fontanilles,Baix Empordà,170708,139,Matching,Non-matching
Fontcoberta,1468,738,730,17071,Fontcoberta,7,"9,5",6,"8,1",13,"8,9",Fontcoberta,Pla de l'Estany,170715,1468,Matching,Matching
Fornells de la Selva,2650,1322,1328,17073,Fornells de la Selva,13,"9,8",11,"8,3",24,"9,1",Fornells de la Selva,Gironès,170736,2650,Matching,Matching
Fortià,763,389,374,17074,Fortià,4,"10,3",3,"7,7",7,"9,2",Fortià,Alt Empordà,170741,763,Matching,Matching
Garrigàs,437,231,206,17075,Garrigàs,0,"0,0",0,"0,0",0,"0,0",Garrigàs,Alt Empordà,170754,437,Matching,Non-matching
Garrigoles,162,84,78,17076,Garrigoles,0,"0,0",0,"0,0",0,"0,0",Garrigoles,Baix Empordà,170767,162,Matching,Non-matching
Garriguella,855,421,434,17077,Garriguella,2,"4,8",1,"2,4",3,"3,5",Garriguella,Alt Empordà,170773,855,Matching,Matching
Ger,448,222,226,17078,Ger,1,"4,5",0,"0,0",1,"2,2",Ger,Cerdanya,170789,448,Matching,Matching
Girona,101852,48931,52921,17079,Girona,650,"13,3",380,"7,8",1030,"10,1",Girona,Gironès,170792,101852,Matching,Matching
Gombrèn,188,96,92,17080,Gombrèn,0,"0,0",1,"10,4",1,"5,3",Gombrèn,Ripollès,170806,188,Matching,Matching
Gualta,397,229,168,17081,Gualta,0,"0,0",0,"0,0",0,"0,0",Gualta,Baix Empordà,170813,397,Matching,Non-matching
Guils de Cerdanya,537,288,249,17082,Guils de Cerdanya,0,"0,0",1,"3,5",1,"1,9",Guils de Cerdanya,Cerdanya,170828,537,Matching,Matching
Hostalric,4221,2130,2091,17083,Hostalric,21,"9,9",14,"6,6",35,"8,3",Hostalric,Selva,170834,4221,Matching,Matching
Isòvol,281,161,120,17084,Isòvol,1,"6,2",1,"6,2",2,"7,1",Isòvol,Cerdanya,170849,281,Matching,Matching
Jafre,380,206,174,17085,Jafre,1,"4,9",0,"0,0",1,"2,6",Jafre,Baix Empordà,170852,380,Matching,Matching
"Jonquera, La",3290,1637,1653,17086,La Jonquera,6,"3,7",10,"6,1",16,"4,9","Jonquera, la",Alt Empordà,170865,3290,Matching,Matching
Juià,323,174,149,17087,Juià,0,"0,0",1,"5,7",1,"3,1",Juià,Gironès,170871,323,Matching,Matching
Lladó,818,398,420,17088,Lladó,12,"30,2",4,"10,1",16,"19,6",Lladó,Alt Empordà,170887,818,Matching,Matching
Llagostera,8453,4303,4150,17089,Llagostera,33,"7,7",22,"5,1",55,"6,5",Llagostera,Gironès,170890,8453,Matching,Matching
Llambilles,696,359,337,17090,Llambilles,2,"5,6",2,"5,6",4,"5,7",Llambilles,Gironès,170904,696,Matching,Matching
Llanars,505,259,246,17091,Llanars,1,"3,9",1,"3,9",2,"4,0",Llanars,Ripollès,170911,505,Matching,Matching
Llançà,4836,2394,2442,17092,Llançà,13,"5,4",7,"2,9",20,"4,1",Llançà,Alt Empordà,170926,4836,Matching,Matching
Llers,1239,617,622,17093,Llers,8,"13,0",3,"4,9",11,"8,9",Llers,Alt Empordà,170932,1239,Matching,Matching
Llívia,1417,748,669,17094,Llívia,3,"4,0",1,"1,3",4,"2,8",Llívia,Cerdanya,170947,1417,Matching,Matching
Lloret de Mar,38373,19528,18845,17095,Lloret de Mar,160,"8,2",101,"5,2",261,"6,8",Lloret de Mar,Selva,170950,38373,Matching,Matching
"Llosses, Les",218,121,97,17096,Les Llosses,0,"0,0",0,"0,0",0,"0,0","Llosses, les",Ripollès,170963,218,Matching,Non-matching
Madremanya,283,138,145,17097,Madremanya,1,"7,2",0,"0,0",1,"3,5",Madremanya,Gironès,170979,283,Matching,Matching
Maià de Montcal,449,251,198,17098,Maià de Montcal,1,"4,0",2,"8,0",3,"6,7",Maià de Montcal,Garrotxa,170985,449,Matching,Matching
Meranges,104,58,46,17099,Meranges,0,"0,0",0,"0,0",0,"0,0",Meranges,Cerdanya,170998,104,Matching,Non-matching
Masarac,288,150,138,17100,Masarac,2,"13,3",0,"0,0",2,"6,9",Masarac,Alt Empordà,171002,288,Matching,Matching
Massanes,761,405,356,17101,Massanes,4,"9,9",5,"12,3",9,"11,8",Massanes,Selva,171019,761,Matching,Matching
Maçanet de Cabrenys,688,340,348,17102,Maçanet de Cabrenys,3,"8,8",2,"5,9",5,"7,3",Maçanet de Cabrenys,Alt Empordà,171024,688,Matching,Matching
Maçanet de la Selva,7006,3598,3408,17103,Maçanet de la Selva,25,"6,9",10,"2,8",35,"5,0",Maçanet de la Selva,Selva,171030,7006,Matching,Matching
Mieres,318,160,158,17105,Mieres,1,"6,3",3,"18,8",4,"12,6",Mieres,Garrotxa,171058,318,Matching,Matching
Mollet de Peralada,189,96,93,17106,Mollet de Peralada,0,"0,0",0,"0,0",0,"0,0",Mollet de Peralada,Alt Empordà,171061,189,Matching,Non-matching
Molló,337,162,175,17107,Molló,1,"6,2",3,"18,5",4,"11,9",Molló,Ripollès,171077,337,Matching,Matching
Montagut i Oix,916,475,441,17109,Montagut i Oix,1,"2,1",2,"4,2",3,"3,3",Montagut i Oix,Garrotxa,171096,916,Matching,Matching
Mont-ras,1679,846,833,17110,Mont-Ras,12,"14,2",2,"2,4",14,"8,3",Mont-ras,Baix Empordà,171100,1679,Matching,Matching
Navata,1381,671,710,17111,Navata,5,"7,5",5,"7,5",10,"7,2",Navata,Alt Empordà,171117,1381,Matching,Matching
Ogassa,234,130,104,17112,Ogassa,0,"0,0",1,"7,7",1,"4,3",Ogassa,Ripollès,171122,234,Matching,Matching
Olot,35228,17569,17659,17114,Olot,188,"10,7",105,"6,0",293,"8,3",Olot,Garrotxa,171143,35228,Matching,Matching
Ordis,371,199,172,17115,Ordis,1,"5,0",2,"10,1",3,"8,1",Ordis,Alt Empordà,171156,371,Matching,Matching
Osor,428,227,201,17116,Osor,0,"0,0",0,"0,0",0,"0,0",Osor,Selva,171169,428,Matching,Non-matching
Palafrugell,22974,11377,11597,17117,Palafrugell,140,"12,3",80,"7,0",220,"9,6",Palafrugell,Baix Empordà,171175,22974,Matching,Matching
Palamós,17910,8766,9144,17118,Palamós,141,"16,1",73,"8,3",214,"11,9",Palamós,Baix Empordà,171181,17910,Matching,Matching
Palau de Santa Eulàlia,91,52,39,17119,Palau de Santa Eulàlia,0,"0,0",0,"0,0",0,"0,0",Palau de Santa Eulàlia,Alt Empordà,171194,91,Matching,Non-matching
Palau-saverdera,1476,741,735,17120,Palau-Saverdera,5,"6,7",6,"8,1",11,"7,5",Palau-saverdera,Alt Empordà,171208,1476,Matching,Matching
Palau-sator,310,166,144,17121,Palau-Sator,1,"6,0",1,"6,0",2,"6,5",Palau-sator,Baix Empordà,171215,310,Matching,Matching
Palol de Revardit,455,228,227,17123,Palol de Revardit,1,"4,4",1,"4,4",2,"4,4",Palol de Revardit,Pla de l'Estany,171236,455,Matching,Matching
Pals,2411,1222,1189,17124,Pals,6,"4,9",4,"3,3",10,"4,1",Pals,Baix Empordà,171241,2411,Matching,Matching
Pardines,162,89,73,17125,Pardines,0,"0,0",0,"0,0",0,"0,0",Pardines,Ripollès,171254,162,Matching,Non-matching
Parlavà,394,199,195,17126,Parlavà,2,"10,1",1,"5,0",3,"7,6",Parlavà,Baix Empordà,171267,394,Matching,Matching
Pau,560,285,275,17128,Pau,0,"0,0",1,"3,5",1,"1,8",Pau,Alt Empordà,171289,560,Matching,Matching
Pedret i Marzà,198,101,97,17129,Pedret i Marzà,0,"0,0",0,"0,0",0,"0,0",Pedret i Marzà,Alt Empordà,171292,198,Matching,Non-matching
"Pera, La",446,221,225,17130,La Pera,2,"9,0",2,"9,0",4,"9,0","Pera, la",Baix Empordà,171306,446,Matching,Matching
Peralada,1850,906,944,17132,Peralada,7,"7,7",3,"3,3",10,"5,4",Peralada,Alt Empordà,171328,1850,Matching,Matching
"Planes d'Hostoles, Les",1683,851,832,17133,Les Planes d'Hostoles,3,"3,5",6,"7,1",9,"5,3","Planes d'Hostoles, les",Garrotxa,171334,1683,Matching,Matching
Planoles,288,157,131,17134,Planoles,0,"0,0",0,"0,0",0,"0,0",Planoles,Ripollès,171349,288,Matching,Non-matching
Pont de Molins,529,267,262,17135,Pont de Molins,3,"11,2",0,"0,0",3,"5,7",Pont de Molins,Alt Empordà,171352,529,Matching,Matching
Pontós,266,141,125,17136,Pontós,0,"0,0",1,"7,1",1,"3,8",Pontós,Alt Empordà,171365,266,Matching,Matching
Porqueres,4621,2288,2333,17137,Porqueres,13,"5,7",18,"7,9",31,"6,7",Porqueres,Pla de l'Estany,171371,4621,Matching,Matching
Portbou,1075,528,547,17138,Portbou,4,"7,6",0,"0,0",4,"3,7",Portbou,Alt Empordà,171387,1075,Matching,Matching
"Preses, Les",1788,890,898,17139,Les Preses,11,"12,4",6,"6,7",17,"9,5","Preses, les",Garrotxa,171390,1788,Matching,Matching
"Port de la Selva, El",970,501,469,17140,El Port de la Selva,2,"4,0",1,"2,0",3,"3,1","Port de la Selva, el",Alt Empordà,171404,970,Matching,Matching
Puigcerdà,9258,4585,4673,17141,Puigcerdà,33,"7,2",17,"3,7",50,"5,4",Puigcerdà,Cerdanya,171411,9258,Matching,Matching
Quart,3724,1855,1869,17142,Quart,17,"9,2",8,"4,3",25,"6,7",Quart,Gironès,171426,3724,Matching,Matching
Rabós,178,89,89,17143,Rabós,0,"0,0",0,"0,0",0,"0,0",Rabós,Alt Empordà,171432,178,Matching,Non-matching
Regencós,269,141,128,17144,Regencós,0,"0,0",1,"7,1",1,"3,7",Regencós,Baix Empordà,171447,269,Matching,Matching
Ribes de Freser,1754,882,872,17145,Ribes de Freser,3,"3,4",3,"3,4",6,"3,4",Ribes de Freser,Ripollès,171450,1754,Matching,Matching
Riells i Viabrea,4124,2113,2011,17146,Riells i Viabrea,18,"8,5",7,"3,3",25,"6,1",Riells i Viabrea,Selva,171463,4124,Matching,Matching
Ripoll,10686,5273,5413,17147,Ripoll,41,"7,8",32,"6,1",73,"6,8",Ripoll,Ripollès,171479,10686,Matching,Matching
Riudarenes,2182,1125,1057,17148,Riudarenes,8,"7,1",6,"5,3",14,"6,4",Riudarenes,Selva,171485,2182,Matching,Matching
Riudaura,478,232,246,17149,Riudaura,3,"12,9",1,"4,3",4,"8,4",Riudaura,Garrotxa,171498,478,Matching,Matching
Riudellots de la Selva,2076,1053,1023,17150,Riudellots de la Selva,5,"4,7",2,"1,9",7,"3,4",Riudellots de la Selva,Selva,171501,2076,Matching,Matching
Riumors,258,126,132,17151,Riumors,2,"15,9",0,"0,0",2,"7,8",Riumors,Alt Empordà,171518,258,Matching,Matching
Roses,19550,9862,9688,17152,Roses,37,"3,8",29,"2,9",66,"3,4",Roses,Alt Empordà,171523,19550,Matching,Matching
Rupià,272,138,134,17153,Rupià,1,"7,2",1,"7,2",2,"7,4",Rupià,Baix Empordà,171539,272,Matching,Matching
Sales de Llierca,154,77,77,17154,Sales de Llierca,0,"0,0",0,"0,0",0,"0,0",Sales de Llierca,Garrotxa,171544,154,Matching,Non-matching
Salt,31362,16454,14908,17155,Salt,145,"8,8",110,"6,7",255,"8,1",Salt,Gironès,171557,31362,Matching,Matching
Sant Andreu Salou,155,79,76,17157,Sant Andreu Salou,0,"0,0",0,"0,0",0,"0,0",Sant Andreu Salou,Gironès,171576,155,Matching,Non-matching
Sant Climent Sescebes,626,364,262,17158,Sant Climent Sescebes,3,"8,2",3,"8,2",6,"9,6",Sant Climent Sescebes,Alt Empordà,171582,626,Matching,Matching
Sant Feliu de Buixalleu,783,410,373,17159,Sant Feliu de Buixalleu,2,"4,9",3,"7,3",5,"6,4",Sant Feliu de Buixalleu,Selva,171595,783,Matching,Matching
Sant Feliu de Guíxols,21925,10802,11123,17160,Sant Feliu de Guíxols,58,"5,4",53,"4,9",111,"5,1",Sant Feliu de Guíxols,Baix Empordà,171609,21925,Matching,Matching
Sant Feliu de Pallerols,1371,667,704,17161,Sant Feliu de Pallerols,6,"9,0",2,"3,0",8,"5,8",Sant Feliu de Pallerols,Garrotxa,171616,1371,Matching,Matching
Sant Ferriol,243,124,119,17162,Sant Ferriol,1,"8,1",0,"0,0",1,"4,1",Sant Ferriol,Garrotxa,171621,243,Matching,Matching
Sant Gregori,3817,1959,1858,17163,Sant Gregori,30,"15,3",21,"10,7",51,"13,4",Sant Gregori,Gironès,171637,3817,Matching,Matching
Sant Hilari Sacalm,5627,2843,2784,17164,Sant Hilari Sacalm,39,"13,7",20,"7,0",59,"10,5",Sant Hilari Sacalm,Selva,171642,5627,Matching,Matching
Sant Jaume de Llierca,865,416,449,17165,Sant Jaume de Llierca,7,"16,8",1,"2,4",8,"9,2",Sant Jaume de Llierca,Garrotxa,171655,865,Matching,Matching
Sant Jordi Desvalls,761,380,381,17166,Sant Jordi Desvalls,5,"13,2",1,"2,6",6,"7,9",Sant Jordi Desvalls,Gironès,171668,761,Matching,Matching
Sant Joan de les Abadesses,3232,1604,1628,17167,Sant Joan de les Abadesses,15,"9,4",12,"7,5",27,"8,4",Sant Joan de les Abadesses,Ripollès,171674,3232,Matching,Matching
Sant Joan de Mollet,507,248,259,17168,Sant Joan de Mollet,1,"4,0",1,"4,0",2,"3,9",Sant Joan de Mollet,Gironès,171680,507,Matching,Matching
Sant Julià de Ramis,3515,1780,1735,17169,Sant Julià de Ramis,21,"11,8",10,"5,6",31,"8,8",Sant Julià de Ramis,Gironès,171693,3515,Matching,Matching
Vallfogona de Ripollès,206,109,97,17170,Vallfogona de Ripollès,0,"0,0",0,"0,0",0,"0,0",Vallfogona de Ripollès,Ripollès,171707,206,Matching,Non-matching
Sant Llorenç de la Muga,264,135,129,17171,Sant Llorenç de la Muga,0,"0,0",0,"0,0",0,"0,0",Sant Llorenç de la Muga,Alt Empordà,171714,264,Matching,Non-matching
Sant Martí de Llémena,633,330,303,17172,Sant Martí de Llémena,1,"3,0",5,"15,2",6,"9,5",Sant Martí de Llémena,Gironès,171729,633,Matching,Matching
Sant Martí Vell,252,131,121,17173,Sant Martí Vell,1,"7,6",0,"0,0",1,"4,0",Sant Martí Vell,Gironès,171735,252,Matching,Matching
Sant Miquel de Campmajor,231,127,104,17174,Sant Miquel de Campmajor,1,"7,9",0,"0,0",1,"4,3",Sant Miquel de Campmajor,Pla de l'Estany,171740,231,Matching,Matching
Sant Miquel de Fluvià,764,397,367,17175,Sant Miquel de Fluvià,5,"12,6",2,"5,0",7,"9,2",Sant Miquel de Fluvià,Alt Empordà,171753,764,Matching,Matching
Sant Mori,177,90,87,17176,Sant Mori,0,"0,0",0,"0,0",0,"0,0",Sant Mori,Alt Empordà,171766,177,Matching,Non-matching
Sant Pau de Segúries,697,347,350,17177,Sant Pau de Segúries,2,"5,8",1,"2,9",3,"4,3",Sant Pau de Segúries,Ripollès,171772,697,Matching,Matching
Sant Pere Pescador,2042,1084,958,17178,Sant Pere Pescador,5,"4,6",3,"2,8",8,"3,9",Sant Pere Pescador,Alt Empordà,171788,2042,Matching,Matching
Santa Coloma de Farners,13143,6621,6522,17180,Santa Coloma de Farners,59,"8,9",40,"6,0",99,"7,5",Santa Coloma de Farners,Selva,171805,13143,Matching,Matching
Santa Cristina d'Aro,5223,2624,2599,17181,Santa Cristina d'Aro,15,"5,7",6,"2,3",21,"4,0",Santa Cristina d'Aro,Baix Empordà,171812,5223,Matching,Matching
Santa Llogaia d'Àlguema,370,189,181,17182,Santa Llogaia d'Àlguema,1,"5,3",1,"5,3",2,"5,4",Santa Llogaia d'Àlguema,Alt Empordà,171827,370,Matching,Matching
Sant Aniol de Finestres,341,177,164,17183,Sant Aniol de Finestres,0,"0,0",0,"0,0",0,"0,0",Sant Aniol de Finestres,Garrotxa,171833,341,Matching,Non-matching
Santa Pau,1565,792,773,17184,Santa Pau,3,"3,8",2,"2,5",5,"3,2",Santa Pau,Garrotxa,171848,1565,Matching,Matching
Sant Joan les Fonts,3006,1541,1465,17185,Sant Joan Les Fonts,22,"14,3",13,"8,4",35,"11,6",Sant Joan les Fonts,Garrotxa,171851,3006,Matching,Matching
Sarrià de Ter,5170,2530,2640,17186,Sarrià de Ter,23,"9,1",20,"7,9",43,"8,3",Sarrià de Ter,Gironès,171864,5170,Matching,Matching
"Saus, Camallera i Llampaies",837,424,413,17187,Saus Camallera i Llampaies,2,"4,7",2,"4,7",4,"4,8","Saus, Camallera i Llampaies",Alt Empordà,171870,837,Matching,Matching
"Selva de Mar, La",196,108,88,17188,La Selva de Mar,0,"0,0",0,"0,0",0,"0,0","Selva de Mar, la",Alt Empordà,171886,196,Matching,Non-matching
"Cellera de Ter, La",1946,965,981,17189,La Cellera de Ter,12,"12,4",3,"3,1",15,"7,7","Cellera de Ter, la",Selva,171899,1946,Matching,Matching
Serinyà,1136,576,560,17190,Serinyà,6,"10,4",7,"12,2",13,"11,4",Serinyà,Pla de l'Estany,171903,1136,Matching,Matching
Serra de Daró,221,122,99,17191,Serra de Daró,0,"0,0",0,"0,0",0,"0,0",Serra de Daró,Baix Empordà,171910,221,Matching,Non-matching
Setcases,177,98,79,17192,Setcases,0,"0,0",0,"0,0",0,"0,0",Setcases,Ripollès,171925,177,Matching,Non-matching
Sils,6093,3108,2985,17193,Sils,32,"10,3",17,"5,5",49,"8,0",Sils,Selva,171931,6093,Matching,Matching
Susqueda,101,60,41,17194,Susqueda,0,"0,0",0,"0,0",0,"0,0",Susqueda,Selva,171946,101,Matching,Non-matching
"Tallada d'Empordà, La",463,241,222,17195,La Tallada d'Empordà,1,"4,1",0,"0,0",1,"2,2","Tallada d'Empordà, la",Baix Empordà,171959,463,Matching,Matching
Terrades,329,162,167,17196,Terrades,3,"18,5",6,"37,0",9,"27,4",Terrades,Alt Empordà,171962,329,Matching,Matching
Torrent,175,92,83,17197,Torrent,0,"0,0",0,"0,0",0,"0,0",Torrent,Baix Empordà,171978,175,Matching,Non-matching
Torroella de Fluvià,694,354,340,17198,Torroella de Fluvià,2,"5,6",1,"2,8",3,"4,3",Torroella de Fluvià,Alt Empordà,171984,694,Matching,Matching
Torroella de Montgrí,11645,5900,5745,17199,Torroella de Montgrí,25,"4,2",16,"2,7",41,"3,5",Torroella de Montgrí,Baix Empordà,171997,11645,Matching,Matching
Tortellà,809,393,416,17200,Tortellà,4,"10,2",1,"2,5",5,"6,2",Tortellà,Garrotxa,172001,809,Matching,Matching
Toses,171,102,69,17201,Toses,0,"0,0",0,"0,0",0,"0,0",Toses,Ripollès,172018,171,Matching,Non-matching
Tossa de Mar,5683,2861,2822,17202,Tossa de Mar,12,"4,2",10,"3,5",22,"3,9",Tossa de Mar,Selva,172023,5683,Matching,Matching
Ultramort,223,118,105,17203,Ultramort,0,"0,0",0,"0,0",0,"0,0",Ultramort,Baix Empordà,172039,223,Matching,Non-matching
Ullà,1153,632,521,17204,Ullà,4,"6,3",2,"3,2",6,"5,2",Ullà,Baix Empordà,172044,1153,Matching,Matching
Ullastret,290,140,150,17205,Ullastret,2,"14,3",0,"0,0",2,"6,9",Ullastret,Baix Empordà,172057,290,Matching,Matching
Urús,189,93,96,17206,Urús,1,"10,8",0,"0,0",1,"5,3",Urús,Cerdanya,172060,189,Matching,Matching
"Vall d'en Bas, La",3072,1553,1519,17207,La Vall d'En Bas,14,"9,0",5,"3,2",19,"6,2","Vall d'en Bas, la",Garrotxa,172076,3072,Matching,Matching
"Vall de Bianya, La",1264,639,625,17208,La Vall de Bianya,10,"15,6",4,"6,3",14,"11,1","Vall de Bianya, la",Garrotxa,172082,1264,Matching,Matching
Vall-llobrega,899,446,453,17209,Vall-Llobrega,3,"6,7",2,"4,5",5,"5,6",Vall-llobrega,Baix Empordà,172095,899,Matching,Matching
Ventalló,859,438,421,17210,Ventalló,7,"16,0",3,"6,8",10,"11,6",Ventalló,Alt Empordà,172109,859,Matching,Matching
Verges,1171,572,599,17211,Verges,3,"5,2",3,"5,2",6,"5,1",Verges,Baix Empordà,172116,1171,Matching,Matching
Vidrà,167,83,84,17212,Vidrà,0,"0,0",0,"0,0",0,"0,0",Vidrà,Osona,172121,167,Matching,Non-matching
Vidreres,7797,4048,3749,17213,Vidreres,26,"6,4",31,"7,7",57,"7,3",Vidreres,Selva,172137,7797,Matching,Matching
Vilabertran,979,489,490,17214,Vilabertran,2,"4,1",2,"4,1",4,"4,1",Vilabertran,Alt Empordà,172142,979,Matching,Matching
Vilablareix,2897,1438,1459,17215,Vilablareix,15,"10,4",12,"8,3",27,"9,3",Vilablareix,Gironès,172155,2897,Matching,Matching
Viladasens,200,107,93,17216,Viladasens,0,"0,0",0,"0,0",0,"0,0",Viladasens,Gironès,172168,200,Matching,Non-matching
Viladamat,468,241,227,17217,Viladamat,0,"0,0",0,"0,0",0,"0,0",Viladamat,Alt Empordà,172174,468,Matching,Non-matching
Vilademuls,815,424,391,17218,Vilademuls,1,"2,4",3,"7,1",4,"4,9",Vilademuls,Pla de l'Estany,172180,815,Matching,Matching
Viladrau,1040,509,531,17220,Viladrau,4,"7,9",0,"0,0",4,"3,8",Viladrau,Osona,172207,1040,Matching,Matching
Vilafant,5394,2636,2758,17221,Vilafant,31,"11,8",15,"5,7",46,"8,5",Vilafant,Alt Empordà,172214,5394,Matching,Matching
Vilaür,157,81,76,17222,Vilaür,0,"0,0",0,"0,0",0,"0,0",Vilaür,Alt Empordà,172229,157,Matching,Non-matching
Vilajuïga,1104,549,555,17223,Vilajuïga,7,"12,8",2,"3,6",9,"8,2",Vilajuïga,Alt Empordà,172235,1104,Matching,Matching
Vilallonga de Ter,398,212,186,17224,Vilallonga de Ter,1,"4,7",1,"4,7",2,"5,0",Vilallonga de Ter,Ripollès,172240,398,Matching,Matching
Vilamacolum,348,193,155,17225,Vilamacolum,0,"0,0",0,"0,0",0,"0,0",Vilamacolum,Alt Empordà,172253,348,Matching,Non-matching
Vilamalla,1181,586,595,17226,Vilamalla,7,"11,9",1,"1,7",8,"6,8",Vilamalla,Alt Empordà,172266,1181,Matching,Matching
Vilamaniscle,200,116,84,17227,Vilamaniscle,0,"0,0",0,"0,0",0,"0,0",Vilamaniscle,Alt Empordà,172272,200,Matching,Non-matching
Vilanant,392,197,195,17228,Vilanant,3,"15,2",1,"5,1",4,"10,2",Vilanant,Alt Empordà,172288,392,Matching,Matching
Vila-sacra,760,372,388,17230,Vila-Sacra,1,"2,7",3,"8,1",4,"5,3",Vila-sacra,Alt Empordà,172305,760,Matching,Matching
Vilopriu,202,107,95,17232,Vilopriu,0,"0,0",1,"9,3",1,"5,0",Vilopriu,Baix Empordà,172327,202,Matching,Matching
Vilobí d'Onyar,3291,1711,1580,17233,Vilobí d'Onyar,7,"4,1",8,"4,7",15,"4,6",Vilobí d'Onyar,Selva,172333,3291,Matching,Matching
Biure,232,118,114,17234,Biure,2,"16,9",0,"0,0",2,"8,6",Biure,Alt Empordà,172348,232,Matching,Matching
"Cruïlles, Monells i Sant Sadurní de l'Heura",1279,640,639,17901,Cruïlles Monells i Sant Sadurní de l'Heura,1,"1,6",2,"3,1",3,"2,3","Cruïlles, Monells i Sant Sadurní de l'Heura",Baix Empordà,179011,1279,Matching,Matching
Forallac,1687,828,859,17902,Forallac,1,"1,2",0,"0,0",1,"0,6",Forallac,Baix Empordà,179026,1687,Matching,Matching
Sant Julià del Llor i Bonmatí,1286,651,635,17903,Sant Julià del Llor i Bonmatí,5,"7,7",1,"1,5",6,"4,7",Sant Julià del Llor i Bonmatí,Selva,179032,1286,Matching,Matching
Abella de la Conca,179,96,83,25001,Abella de la Conca,0,"0,0",0,"0,0",0,"0,0",Abella de la Conca,Pallars Jussà,250019,179,Matching,Non-matching
Àger,588,320,268,25002,Àger,25,"78,1",20,"62,5",45,"76,5",Àger,Noguera,250024,588,Matching,Matching
Agramunt,5371,2689,2682,25003,Agramunt,20,"7,4",10,"3,7",30,"5,6",Agramunt,Urgell,250030,5371,Matching,Matching
"Alamús, Els",819,412,407,25004,Els Alamús,2,"4,9",3,"7,3",5,"6,1","Alamús, els",Segrià,250045,819,Matching,Matching
Alàs i Cerc,329,171,158,25005,Alàs i Cerc,1,"5,8",0,"0,0",1,"3,0",Alàs i Cerc,Alt Urgell,250058,329,Matching,Matching
"Albagés, L'",369,194,175,25006,l'Albagés,2,"10,3",1,"5,2",3,"8,1","Albagés, l'",Garrigues,250061,369,Matching,Matching
Albatàrrec,2221,1150,1071,25007,Albatàrrec,9,"7,8",5,"4,3",14,"6,3",Albatàrrec,Segrià,250077,2221,Matching,Matching
Albesa,1556,855,701,25008,Albesa,4,"4,7",1,"1,2",5,"3,2",Albesa,Noguera,250083,1556,Matching,Matching
"Albi, L'",764,389,375,25009,L' Albi,0,"0,0",0,"0,0",0,"0,0","Albi, l'",Garrigues,250096,764,Matching,Non-matching
Alcanó,235,119,116,25010,Alcanó,2,"16,8",0,"0,0",2,"8,5",Alcanó,Segrià,250100,235,Matching,Matching
Alcarràs,9514,4957,4557,25011,Alcarràs,40,"8,1",20,"4,0",60,"6,3",Alcarràs,Segrià,250117,9514,Matching,Matching
Alcoletge,3420,1775,1645,25012,Alcoletge,12,"6,8",9,"5,1",21,"6,1",Alcoletge,Segrià,250122,3420,Matching,Matching
Alfarràs,2797,1459,1338,25013,Alfarràs,15,"10,3",7,"4,8",22,"7,9",Alfarràs,Segrià,250138,2797,Matching,Matching
Alfés,312,162,150,25014,Alfés,0,"0,0",0,"0,0",0,"0,0",Alfés,Segrià,250143,312,Matching,Non-matching
Algerri,386,206,180,25015,Algerri,1,"4,9",1,"4,9",2,"5,2",Algerri,Noguera,250156,386,Matching,Matching
Alguaire,2971,1562,1409,25016,Alguaire,10,"6,4",5,"3,2",15,"5,0",Alguaire,Segrià,250169,2971,Matching,Matching
Alins,276,144,132,25017,Alins,1,"6,9",0,"0,0",1,"3,6",Alins,Pallars Sobirà,250175,276,Matching,Matching
Almacelles,6791,3584,3207,25019,Almacelles,25,"7,0",12,"3,3",37,"5,4",Almacelles,Segrià,250194,6791,Matching,Matching
Almatret,307,172,135,25020,Almatret,0,"0,0",0,"0,0",0,"0,0",Almatret,Segrià,250208,307,Matching,Non-matching
Almenar,3398,1791,1607,25021,Almenar,23,"12,8",13,"7,3",36,"10,6",Almenar,Segrià,250215,3398,Matching,Matching
Alòs de Balaguer,130,74,56,25022,Alòs de Balaguer,0,"0,0",0,"0,0",0,"0,0",Alòs de Balaguer,Noguera,250220,130,Matching,Non-matching
Alpicat,6255,3134,3121,25023,Alpicat,34,"10,8",14,"4,5",48,"7,7",Alpicat,Segrià,250236,6255,Matching,Matching
Alt Àneu,405,231,174,25024,Alt Àneu,1,"4,3",1,"4,3",2,"4,9",Alt Àneu,Pallars Sobirà,250241,405,Matching,Matching
Naut Aran,1803,935,868,25025,Naut Aran,1,"1,1",3,"3,2",4,"2,2",Naut Aran,Val d'Aran,250254,1803,Matching,Matching
Anglesola,1363,682,681,25027,Anglesola,4,"5,9",1,"1,5",5,"3,7",Anglesola,Urgell,250273,1363,Matching,Matching
Arbeca,2144,1100,1044,25029,Arbeca,4,"3,6",3,"2,7",7,"3,3",Arbeca,Garrigues,250292,2144,Matching,Matching
"Pont de Bar, El",157,87,70,25030,"Pont de Bar, El",0,"0,0",0,"0,0",0,"0,0","Pont de Bar, el",Alt Urgell,250306,157,Matching,Non-matching
Arres,65,42,23,25031,Arres,0,"0,0",0,"0,0",0,"0,0",Arres,Val d'Aran,250313,65,Matching,Non-matching
Arsèguel,84,48,36,25032,Arsèguel,0,"0,0",0,"0,0",0,"0,0",Arsèguel,Alt Urgell,250328,84,Matching,Non-matching
Artesa de Lleida,1504,789,715,25033,Artesa de Lleida,5,"6,3",6,"7,6",11,"7,3",Artesa de Lleida,Segrià,250334,1504,Matching,Matching
Artesa de Segre,3432,1766,1666,25034,Artesa de Segre,7,"4,0",4,"2,3",11,"3,2",Artesa de Segre,Noguera,250349,3432,Matching,Matching
"Sentiu de Sió, La",406,216,190,25035,La Sentiu de Sió,4,"18,5",1,"4,6",5,"12,3","Sentiu de Sió, la",Noguera,250352,406,Matching,Matching
Aspa,224,113,111,25036,Aspa,1,"8,8",0,"0,0",1,"4,5",Aspa,Segrià,250365,224,Matching,Matching
"Avellanes i Santa Linya, Les",449,259,190,25037,Les Avellanes i Santa Linya,4,"15,4",0,"0,0",4,"8,9","Avellanes i Santa Linya, les",Noguera,250371,449,Matching,Matching
Aitona,2591,1358,1233,25038,Aitona,12,"8,8",35,"25,8",47,"18,1",Aitona,Segrià,250387,2591,Matching,Matching
Baix Pallars,335,182,153,25039,Baix Pallars,0,"0,0",0,"0,0",0,"0,0",Baix Pallars,Pallars Sobirà,250390,335,Matching,Non-matching
Balaguer,17162,8746,8416,25040,Balaguer,105,"12,0",64,"7,3",169,"9,8",Balaguer,Noguera,250404,17162,Matching,Matching
Barbens,878,467,411,25041,Barbens,4,"8,6",5,"10,7",9,"10,3",Barbens,Pla d'Urgell,250411,878,Matching,Matching
"Baronia de Rialb, La",237,121,116,25042,La Baronia de Rialb,0,"0,0",1,"8,3",1,"4,2","Baronia de Rialb, la",Noguera,250426,237,Matching,Matching
"Vall de Boí, La",1021,546,475,25043,La Vall de Boí,2,"3,7",0,"0,0",2,"2,0","Vall de Boí, la",Alta Ribagorça,250432,1021,Matching,Matching
Bassella,224,112,112,25044,Bassella,0,"0,0",2,"17,9",2,"8,9",Bassella,Alt Urgell,250447,224,Matching,Matching
Bausen,58,30,28,25045,Bausen,0,"0,0",0,"0,0",0,"0,0",Bausen,Val d'Aran,250450,58,Matching,Non-matching
Belianes,525,269,256,25046,Belianes,4,"14,9",0,"0,0",4,"7,6",Belianes,Urgell,250463,525,Matching,Matching
Bellcaire d'Urgell,1230,627,603,25047,Bellcaire d'Urgell,5,"8,0",0,"0,0",5,"4,1",Bellcaire d'Urgell,Noguera,250479,1230,Matching,Matching
Bell-lloc d'Urgell,2315,1139,1176,25048,Bell-Lloc d'Urgell,8,"7,0",12,"10,5",20,"8,6",Bell-lloc d'Urgell,Pla d'Urgell,250485,2315,Matching,Matching
Bellmunt d'Urgell,185,89,96,25049,Bellmunt d'Urgell,0,"0,0",0,"0,0",0,"0,0",Bellmunt d'Urgell,Noguera,250498,185,Matching,Non-matching
Bellpuig,5133,2705,2428,25050,Bellpuig,13,"4,8",5,"1,8",18,"3,5",Bellpuig,Urgell,250501,5133,Matching,Matching
Bellver de Cerdanya,1937,1009,928,25051,Bellver de Cerdanya,3,"3,0",4,"4,0",7,"3,6",Bellver de Cerdanya,Cerdanya,250518,1937,Matching,Matching
Bellvís,2255,1149,1106,25052,Bellvís,4,"3,5",5,"4,4",9,"4,0",Bellvís,Pla d'Urgell,250523,2255,Matching,Matching
Benavent de Segrià,1499,781,718,25053,Benavent de Segrià,7,"9,0",6,"7,7",13,"8,7",Benavent de Segrià,Segrià,250539,1499,Matching,Matching
Biosca,176,94,82,25055,Biosca,1,"10,6",1,"10,6",2,"11,4",Biosca,Segarra,250557,176,Matching,Matching
Bovera,247,133,114,25056,Bovera,0,"0,0",1,"7,5",1,"4,0",Bovera,Garrigues,250560,247,Matching,Matching
"Bòrdes, Es",259,144,115,25057,Es Bòrdes,1,"6,9",0,"0,0",1,"3,9","Bòrdes, Es",Val d'Aran,250576,259,Matching,Matching
"Borges Blanques, Les",6087,3105,2982,25058,Les Borges Blanques,14,"4,5",7,"2,3",21,"3,4","Borges Blanques, les",Garrigues,250582,6087,Matching,Matching
Bossòst,1109,542,567,25059,Bossòst,15,"27,7",5,"9,2",20,"18,0",Bossòst,Val d'Aran,250595,1109,Matching,Matching
Cabanabona,75,36,39,25060,Cabanabona,0,"0,0",0,"0,0",0,"0,0",Cabanabona,Noguera,250609,75,Matching,Non-matching
Cabó,92,49,43,25061,Cabó,0,"0,0",0,"0,0",0,"0,0",Cabó,Alt Urgell,250616,92,Matching,Non-matching
Camarasa,817,410,407,25062,Camarasa,5,"12,2",4,"9,8",9,"11,0",Camarasa,Noguera,250621,817,Matching,Matching
Canejan,107,57,50,25063,Canejan,0,"0,0",0,"0,0",0,"0,0",Canejan,Val d'Aran,250637,107,Matching,Non-matching
Castellar de la Ribera,134,67,67,25064,Castellar de la Ribera,0,"0,0",0,"0,0",0,"0,0",Castellar de la Ribera,Solsonès,250642,134,Matching,Non-matching
Castelldans,960,511,449,25067,Castelldans,2,"3,9",2,"3,9",4,"4,2",Castelldans,Garrigues,250674,960,Matching,Matching
Castellnou de Seana,683,361,322,25068,Castellnou de Seana,1,"2,8",2,"5,5",3,"4,4",Castellnou de Seana,Pla d'Urgell,250680,683,Matching,Matching
Castelló de Farfanya,536,288,248,25069,Castelló de Farfanya,1,"3,5",1,"3,5",2,"3,7",Castelló de Farfanya,Noguera,250693,536,Matching,Matching
Castellserà,1003,506,497,25070,Castellserà,6,"11,9",2,"4,0",8,"8,0",Castellserà,Urgell,250707,1003,Matching,Matching
Cava,47,29,18,25071,Cava,0,"0,0",0,"0,0",0,"0,0",Cava,Alt Urgell,250714,47,Matching,Non-matching
Cervera,9180,4670,4510,25072,Cervera,53,"11,3",26,"5,6",79,"8,6",Cervera,Segarra,250729,9180,Matching,Matching
Cervià de les Garrigues,640,336,304,25073,Cervià de les Garrigues,2,"6,0",3,"8,9",5,"7,8",Cervià de les Garrigues,Garrigues,250735,640,Matching,Matching
Ciutadilla,208,111,97,25074,Ciutadilla,0,"0,0",1,"9,0",1,"4,8",Ciutadilla,Urgell,250740,208,Matching,Matching
Clariana de Cardener,157,82,75,25075,Clariana de Cardener,0,"0,0",0,"0,0",0,"0,0",Clariana de Cardener,Solsonès,250753,157,Matching,Non-matching
"Cogul, El",158,88,70,25076,El Cogul,0,"0,0",0,"0,0",0,"0,0","Cogul, el",Garrigues,250766,158,Matching,Non-matching
Coll de Nargó,550,285,265,25077,Coll de Nargó,0,"0,0",0,"0,0",0,"0,0",Coll de Nargó,Alt Urgell,250772,550,Matching,Non-matching
Corbins,1444,787,657,25078,Corbins,1,"1,3",2,"2,5",3,"2,1",Corbins,Segrià,250788,1444,Matching,Matching
Cubells,343,180,163,25079,Cubells,1,"5,6",1,"5,6",2,"5,8",Cubells,Noguera,250791,343,Matching,Matching
"Espluga Calba, L'",341,171,170,25081,L'Espluga Calba,1,"5,8",0,"0,0",1,"2,9","Espluga Calba, l'",Garrigues,250812,341,Matching,Matching
Espot,364,193,171,25082,Espot,1,"5,2",1,"5,2",2,"5,5",Espot,Pallars Sobirà,250827,364,Matching,Matching
Estaràs,162,85,77,25085,Estaràs,0,"0,0",0,"0,0",0,"0,0",Estaràs,Segarra,250851,162,Matching,Non-matching
Esterri d'Àneu,772,364,408,25086,Esterri d'Àneu,1,"2,7",2,"5,5",3,"3,9",Esterri d'Àneu,Pallars Sobirà,250864,772,Matching,Matching
Esterri de Cardós,70,37,33,25087,Esterri de Cardós,0,"0,0",0,"0,0",0,"0,0",Esterri de Cardós,Pallars Sobirà,250870,70,Matching,Non-matching
Estamariu,118,68,50,25088,Estamariu,0,"0,0",0,"0,0",0,"0,0",Estamariu,Alt Urgell,250886,118,Matching,Non-matching
Farrera,116,65,51,25089,Farrera,0,"0,0",0,"0,0",0,"0,0",Farrera,Pallars Sobirà,250899,116,Matching,Non-matching
"Floresta, La",147,79,68,25092,La Floresta,0,"0,0",0,"0,0",0,"0,0","Floresta, la",Garrigues,250925,147,Matching,Non-matching
Fondarella,784,387,397,25093,Fondarella,4,"10,3",3,"7,8",7,"8,9",Fondarella,Pla d'Urgell,250931,784,Matching,Matching
Foradada,186,108,78,25094,Foradada,0,"0,0",0,"0,0",0,"0,0",Foradada,Noguera,250946,186,Matching,Non-matching
"Fuliola, La",1248,619,629,25096,La Fuliola,23,"37,2",20,"32,3",43,"34,5","Fuliola, la",Urgell,250962,1248,Matching,Matching
Fulleda,85,44,41,25097,Fulleda,0,"0,0",0,"0,0",0,"0,0",Fulleda,Garrigues,250978,85,Matching,Non-matching
Gavet de la Conca,261,129,132,25098,Gavet de la Conca,3,"23,3",2,"15,5",5,"19,2",Gavet de la Conca,Pallars Jussà,250984,261,Matching,Matching
Golmés,1840,917,923,25099,Golmés,5,"5,5",1,"1,1",6,"3,3",Golmés,Pla d'Urgell,250997,1840,Matching,Matching
Gósol,206,118,88,25100,Gósol,0,"0,0",0,"0,0",0,"0,0",Gósol,Berguedà,251001,206,Matching,Non-matching
"Granadella, La",712,387,325,25101,La Granadella,2,"5,2",4,"10,3",6,"8,4","Granadella, la",Garrigues,251018,712,Matching,Matching
"Granja d'Escarp, La",936,514,422,25102,La Granja d'Escarp,1,"1,9",2,"3,9",3,"3,2","Granja d'Escarp, la",Segrià,251023,936,Matching,Matching
Granyanella,148,82,66,25103,Granyanella,0,"0,0",0,"0,0",0,"0,0",Granyanella,Segarra,251039,148,Matching,Non-matching
Granyena de Segarra,142,76,66,25104,Granyena de Segarra,0,"0,0",0,"0,0",0,"0,0",Granyena de Segarra,Segarra,251044,142,Matching,Non-matching
Granyena de les Garrigues,132,78,54,25105,Granyena de les Garrigues,0,"0,0",0,"0,0",0,"0,0",Granyena de les Garrigues,Garrigues,251057,132,Matching,Non-matching
Guimerà,265,140,125,25109,Guimerà,0,"0,0",1,"7,1",1,"3,8",Guimerà,Urgell,251095,265,Matching,Matching
Guissona,7136,3810,3326,25110,Guissona,58,"15,2",33,"8,7",91,"12,8",Guissona,Segarra,251109,7136,Matching,Matching
Guixers,134,84,50,25111,Guixers,0,"0,0",0,"0,0",0,"0,0",Guixers,Solsonès,251116,134,Matching,Non-matching
Ivars de Noguera,334,171,163,25112,Ivars de Noguera,1,"5,8",2,"11,7",3,"9,0",Ivars de Noguera,Noguera,251121,334,Matching,Matching
Ivars d'Urgell,1531,801,730,25113,Ivars d'Urgell,1,"1,2",0,"0,0",1,"0,7",Ivars d'Urgell,Pla d'Urgell,251137,1531,Matching,Matching
Ivorra,104,57,47,25114,Ivorra,0,"0,0",0,"0,0",0,"0,0",Ivorra,Segarra,251142,104,Matching,Non-matching
Isona i Conca Dellà,1019,548,471,25115,Isona i Conca Dellà,3,"5,5",3,"5,5",6,"5,9",Isona i Conca Dellà,Pallars Jussà,251155,1019,Matching,Matching
Juncosa,386,204,182,25118,Juncosa,2,"9,8",1,"4,9",3,"7,8",Juncosa,Garrigues,251180,386,Matching,Matching
Juneda,3475,1854,1621,25119,Juneda,25,"13,5",12,"6,5",37,"10,6",Juneda,Garrigues,251193,3475,Matching,Matching
Lleida,138956,68657,70299,25120,Lleida,674,"9,8",458,"6,7",1132,"8,1",Lleida,Segrià,251207,138956,Matching,Matching
Les,946,463,483,25121,Les,2,"4,3",2,"4,3",4,"4,2",Les,Val d'Aran,251214,946,Matching,Matching
Linyola,2700,1365,1335,25122,Linyola,6,"4,4",2,"1,5",8,"3,0",Linyola,Pla d'Urgell,251229,2700,Matching,Matching
Lladorre,230,116,114,25123,Lladorre,0,"0,0",0,"0,0",0,"0,0",Lladorre,Pallars Sobirà,251235,230,Matching,Non-matching
Lladurs,176,91,85,25124,Lladurs,0,"0,0",0,"0,0",0,"0,0",Lladurs,Solsonès,251240,176,Matching,Non-matching
Llardecans,451,236,215,25125,Llardecans,1,"4,2",3,"12,7",4,"8,9",Llardecans,Segrià,251253,451,Matching,Matching
Llavorsí,352,180,172,25126,Llavorsí,0,"0,0",1,"5,6",1,"2,8",Llavorsí,Pallars Sobirà,251266,352,Matching,Matching
Lles de Cerdanya,253,148,105,25127,Lles de Cerdanya,0,"0,0",1,"6,8",1,"4,0",Lles de Cerdanya,Cerdanya,251272,253,Matching,Matching
Llimiana,145,88,57,25128,Llimiana,0,"0,0",0,"0,0",0,"0,0",Llimiana,Pallars Jussà,251288,145,Matching,Non-matching
Llobera,188,104,84,25129,Llobera,0,"0,0",0,"0,0",0,"0,0",Llobera,Solsonès,251291,188,Matching,Non-matching
Maldà,220,109,111,25130,Maldà,0,"0,0",0,"0,0",0,"0,0",Maldà,Urgell,251305,220,Matching,Non-matching
Massalcoreig,598,338,260,25131,Massalcoreig,0,"0,0",0,"0,0",0,"0,0",Massalcoreig,Segrià,251312,598,Matching,Non-matching
Massoteres,218,119,99,25132,Massoteres,1,"8,4",1,"8,4",2,"9,2",Massoteres,Segarra,251327,218,Matching,Matching
Maials,920,517,403,25133,Maials,6,"11,6",2,"3,9",8,"8,7",Maials,Segrià,251333,920,Matching,Matching
Menàrguens,806,440,366,25134,Menàrguens,0,"0,0",0,"0,0",0,"0,0",Menàrguens,Noguera,251348,806,Matching,Non-matching
Miralcamp,1351,677,674,25135,Miralcamp,6,"8,9",0,"0,0",6,"4,4",Miralcamp,Pla d'Urgell,251351,1351,Matching,Matching
"Molsosa, La",107,53,54,25136,"Molsosa, La",0,"0,0",0,"0,0",0,"0,0","Molsosa, la",Solsonès,251364,107,Matching,Non-matching
Mollerussa,14683,7543,7140,25137,Mollerussa,33,"4,4",25,"3,3",58,"4,0",Mollerussa,Pla d'Urgell,251370,14683,Matching,Matching
Montgai,625,329,296,25138,Montgai,1,"3,0",1,"3,0",2,"3,2",Montgai,Noguera,251386,625,Matching,Matching
Montellà i Martinet,579,324,255,25139,Mortellà i Martinet,1,"3,1",2,"6,2",3,"5,2",Montellà i Martinet,Cerdanya,251399,579,Matching,Matching
Montferrer i Castellbò,1041,566,475,25140,Montferrer i Castellbò,2,"3,5",2,"3,5",4,"3,8",Montferrer i Castellbò,Alt Urgell,251403,1041,Matching,Matching
Montoliu de Segarra,179,100,79,25141,Montoliu de Segarra,0,"0,0",0,"0,0",0,"0,0",Montoliu de Segarra,Segarra,251410,179,Matching,Non-matching
Montoliu de Lleida,489,251,238,25142,Montoliu de Lleida,0,"0,0",0,"0,0",0,"0,0",Montoliu de Lleida,Segrià,251425,489,Matching,Non-matching
Montornès de Segarra,100,47,53,25143,Montornès de Segarra,0,"0,0",0,"0,0",0,"0,0",Montornès de Segarra,Segarra,251431,100,Matching,Non-matching
Nalec,87,45,42,25145,Nalec,0,"0,0",0,"0,0",0,"0,0",Nalec,Urgell,251459,87,Matching,Non-matching
Navès,280,147,133,25146,Navès,1,"6,8",0,"0,0",1,"3,6",Navès,Solsonès,251462,280,Matching,Matching
Odèn,249,149,100,25148,Odèn,0,"0,0",0,"0,0",0,"0,0",Odèn,Solsonès,251484,249,Matching,Non-matching
Oliana,1810,906,904,25149,Oliana,7,"7,7",9,"9,9",16,"8,8",Oliana,Alt Urgell,251497,1810,Matching,Matching
Oliola,197,106,91,25150,Oliola,0,"0,0",0,"0,0",0,"0,0",Oliola,Noguera,251500,197,Matching,Non-matching
Olius,986,527,459,25151,Olius,2,"3,8",2,"3,8",4,"4,1",Olius,Solsonès,251517,986,Matching,Matching
"Oluges, Les",167,88,79,25152,"Oluges, Les",0,"0,0",0,"0,0",0,"0,0","Oluges, les",Segarra,251522,167,Matching,Non-matching
"Omellons, Els",211,111,100,25153,Els Omellons,0,"0,0",1,"9,0",1,"4,7","Omellons, els",Garrigues,251538,211,Matching,Matching
"Omells de na Gaia, Els",131,72,59,25154,"Omells de na Gaia, Els",0,"0,0",0,"0,0",0,"0,0","Omells de na Gaia, els",Urgell,251543,131,Matching,Non-matching
Organyà,784,388,396,25155,Organyà,2,"5,2",2,"5,2",4,"5,1",Organyà,Alt Urgell,251556,784,Matching,Matching
Os de Balaguer,994,507,487,25156,Os de Balaguer,3,"5,9",2,"3,9",5,"5,0",Os de Balaguer,Noguera,251569,994,Matching,Matching
Ossó de Sió,204,98,106,25157,Ossó de Sió,0,"0,0",0,"0,0",0,"0,0",Ossó de Sió,Urgell,251575,204,Matching,Non-matching
"Palau d'Anglesola, El",2166,1061,1105,25158,El Palau d'Anglesola,6,"5,7",6,"5,7",12,"5,5","Palau d'Anglesola, el",Pla d'Urgell,251581,2166,Matching,Matching
Conca de Dalt,418,213,205,25161,Conca de Dalt,2,"9,4",1,"4,7",3,"7,2",Conca de Dalt,Pallars Jussà,251615,418,Matching,Matching
"Coma i la Pedra, La",265,157,108,25163,La Coma i la Pedra,0,"0,0",0,"0,0",0,"0,0","Coma i la Pedra, la",Solsonès,251636,265,Matching,Non-matching
Penelles,452,262,190,25164,Penelles,0,"0,0",4,"15,3",4,"8,8",Penelles,Noguera,251641,452,Matching,Matching
Peramola,347,177,170,25165,Peramola,0,"0,0",0,"0,0",0,"0,0",Peramola,Alt Urgell,251654,347,Matching,Non-matching
Pinell de Solsonès,200,118,82,25166,Pinell de Solsonès,0,"0,0",0,"0,0",0,"0,0",Pinell de Solsonès,Solsonès,251667,200,Matching,Non-matching
Pinós,287,151,136,25167,Pinós,0,"0,0",0,"0,0",0,"0,0",Pinós,Solsonès,251673,287,Matching,Non-matching
"Poal, El",648,340,308,25168,El Poal,0,"0,0",1,"2,9",1,"1,5","Poal, el",Pla d'Urgell,251689,648,Matching,Matching
"Pobla de Cérvoles, La",191,107,84,25169,La Pobla de Cérvoles,0,"0,0",1,"9,3",1,"5,2","Pobla de Cérvoles, la",Garrigues,251692,191,Matching,Matching
Bellaguarda,287,152,135,25170,Bellaguarda,4,"26,3",4,"26,3",8,"27,9",Bellaguarda,Garrigues,251706,287,Matching,Matching
"Pobla de Segur, La",2984,1469,1515,25171,La Pobla de Segur,45,"30,6",34,"23,1",79,"26,5","Pobla de Segur, la",Pallars Jussà,251713,2984,Matching,Matching
Ponts,2601,1305,1296,25172,Ponts,6,"4,6",6,"4,6",12,"4,6",Ponts,Noguera,251728,2601,Matching,Matching
"Pont de Suert, El",2220,1107,1113,25173,El Pont de Suert,4,"3,6",3,"2,7",7,"3,2","Pont de Suert, el",Alta Ribagorça,251734,2220,Matching,Matching
"Portella, La",728,412,316,25174,La Portella,1,"2,4",3,"7,3",4,"5,5","Portella, la",Segrià,251749,728,Matching,Matching
Prats i Sansor,219,114,105,25175,Prats i Sansor,0,"0,0",0,"0,0",0,"0,0",Prats i Sansor,Cerdanya,251752,219,Matching,Non-matching
Preixana,385,199,186,25176,Preixana,1,"5,0",0,"0,0",1,"2,6",Preixana,Urgell,251765,385,Matching,Matching
Preixens,432,218,214,25177,Preixens,0,"0,0",0,"0,0",0,"0,0",Preixens,Noguera,251771,432,Matching,Non-matching
Prullans,231,109,122,25179,Prullans,0,"0,0",0,"0,0",0,"0,0",Prullans,Cerdanya,251790,231,Matching,Non-matching
Puiggròs,276,138,138,25180,Puiggròs,2,"14,5",0,"0,0",2,"7,2",Puiggròs,Garrigues,251804,276,Matching,Matching
Puigverd d'Agramunt,255,146,109,25181,Puigverd d'Agramunt,1,"6,8",0,"0,0",1,"3,9",Puigverd d'Agramunt,Urgell,251811,255,Matching,Matching
Puigverd de Lleida,1355,701,654,25182,Puigverd de Lleida,4,"5,7",4,"5,7",8,"5,9",Puigverd de Lleida,Segrià,251826,1355,Matching,Matching
Rialp,661,330,331,25183,Rialp,1,"3,0",1,"3,0",2,"3,0",Rialp,Pallars Sobirà,251832,661,Matching,Matching
Ribera d'Urgellet,935,488,447,25185,Ribera d'Urgellet,1,"2,0",3,"6,1",4,"4,3",Ribera d'Urgellet,Alt Urgell,251850,935,Matching,Matching
Riner,263,132,131,25186,Riner,1,"7,6",0,"0,0",1,"3,8",Riner,Solsonès,251863,263,Matching,Matching
Rosselló,3145,1602,1543,25189,Rosselló,9,"5,6",8,"5,0",17,"5,4",Rosselló,Segrià,251898,3145,Matching,Matching
Salàs de Pallars,320,174,146,25190,Salàs de Pallars,2,"11,5",1,"5,7",3,"9,4",Salàs de Pallars,Pallars Jussà,251902,320,Matching,Matching
Sanaüja,380,202,178,25191,Sanaüja,1,"5,0",0,"0,0",1,"2,6",Sanaüja,Segarra,251919,380,Matching,Matching
Sant Guim de Freixenet,1025,538,487,25192,Sant Guim de Freixenet,5,"9,3",4,"7,4",9,"8,8",Sant Guim de Freixenet,Segarra,251924,1025,Matching,Matching
Sant Llorenç de Morunys,949,457,492,25193,Sant Llorenç de Morunys,0,"0,0",0,"0,0",0,"0,0",Sant Llorenç de Morunys,Solsonès,251930,949,Matching,Non-matching
Sant Ramon,491,254,237,25194,Sant Ramon,1,"3,9",2,"7,9",3,"6,1",Sant Ramon,Segarra,251945,491,Matching,Matching
Sant Esteve de la Sarga,124,72,52,25196,Sant Esteve de la Sarga,0,"0,0",0,"0,0",0,"0,0",Sant Esteve de la Sarga,Pallars Jussà,251961,124,Matching,Non-matching
Sant Guim de la Plana,185,106,79,25197,Sant Guim de la Plana,0,"0,0",0,"0,0",0,"0,0",Sant Guim de la Plana,Segarra,251977,185,Matching,Non-matching
Sarroca de Lleida,363,200,163,25200,Sarroca de Lleida,0,"0,0",0,"0,0",0,"0,0",Sarroca de Lleida,Segrià,252000,363,Matching,Non-matching
Sarroca de Bellera,121,68,53,25201,Sarroca de Bellera,0,"0,0",0,"0,0",0,"0,0",Sarroca de Bellera,Pallars Jussà,252017,121,Matching,Non-matching
Senterada,137,80,57,25202,Senterada,0,"0,0",0,"0,0",0,"0,0",Senterada,Pallars Jussà,252022,137,Matching,Non-matching
"Seu d'Urgell, La",12089,5842,6247,25203,La Seu d'Urgell,29,"5,0",30,"5,1",59,"4,9","Seu d'Urgell, la",Alt Urgell,252038,12089,Matching,Matching
Seròs,1922,1029,893,25204,Seròs,2,"1,9",3,"2,9",5,"2,6",Seròs,Segrià,252043,1922,Matching,Matching
Sidamon,734,383,351,25205,Sidamon,1,"2,6",2,"5,2",3,"4,1",Sidamon,Pla d'Urgell,252056,734,Matching,Matching
"Soleràs, El",332,173,159,25206,"Soleràs, El",0,"0,0",0,"0,0",0,"0,0","Soleràs, el",Garrigues,252069,332,Matching,Non-matching
Solsona,9094,4488,4606,25207,Solsona,9,"2,0",7,"1,6",16,"1,8",Solsona,Solsonès,252075,9094,Matching,Matching
Soriguera,410,220,190,25208,Soriguera,0,"0,0",0,"0,0",0,"0,0",Soriguera,Pallars Sobirà,252081,410,Matching,Non-matching
Sort,2149,1077,1072,25209,Sort,10,"9,3",5,"4,6",15,"7,0",Sort,Pallars Sobirà,252094,2149,Matching,Matching
Soses,1763,923,840,25210,Soses,4,"4,3",1,"1,1",5,"2,8",Soses,Segrià,252108,1763,Matching,Matching
Sudanell,853,465,388,25211,Sudanell,1,"2,2",2,"4,3",3,"3,5",Sudanell,Segrià,252115,853,Matching,Matching
Sunyer,352,205,147,25212,Sunyer,0,"0,0",1,"4,9",1,"2,8",Sunyer,Segrià,252120,352,Matching,Matching
Talarn,585,387,198,25215,Talarn,0,"0,0",0,"0,0",0,"0,0",Talarn,Pallars Jussà,252154,585,Matching,Non-matching
Talavera,283,158,125,25216,Talavera,1,"6,3",1,"6,3",2,"7,1",Talavera,Segarra,252167,283,Matching,Matching
Tàrrega,17098,8489,8609,25217,Tàrrega,53,"6,2",50,"5,9",103,"6,0",Tàrrega,Urgell,252173,17098,Matching,Matching
Tarrés,106,56,50,25218,Tarrés,0,"0,0",0,"0,0",0,"0,0",Tarrés,Garrigues,252189,106,Matching,Non-matching
Tarroja de Segarra,187,104,83,25219,Tarroja de Segarra,0,"0,0",0,"0,0",0,"0,0",Tarroja de Segarra,Segarra,252192,187,Matching,Non-matching
Térmens,1333,678,655,25220,Térmens,3,"4,4",3,"4,4",6,"4,5",Térmens,Noguera,252206,1333,Matching,Matching
Tírvia,131,63,68,25221,Tírvia,0,"0,0",0,"0,0",0,"0,0",Tírvia,Pallars Sobirà,252213,131,Matching,Non-matching
Tiurana,73,33,40,25222,Tiurana,0,"0,0",0,"0,0",0,"0,0",Tiurana,Noguera,252228,73,Matching,Non-matching
Torà,1255,639,616,25223,Torà,4,"6,3",2,"3,1",6,"4,8",Torà,Segarra,252234,1255,Matching,Matching
"Torms, Els",144,77,67,25224,"Torms, Els",0,"0,0",0,"0,0",0,"0,0","Torms, els",Garrigues,252249,144,Matching,Non-matching
Tornabous,858,461,397,25225,Tornabous,3,"6,5",5,"10,8",8,"9,3",Tornabous,Urgell,252252,858,Matching,Matching
Torrebesses,282,150,132,25226,Torrebesses,0,"0,0",0,"0,0",0,"0,0",Torrebesses,Segrià,252265,282,Matching,Non-matching
"Torre de Cabdella, La",760,383,377,25227,"Torre de Cabdella, La",0,"0,0",0,"0,0",0,"0,0","Torre de Cabdella, la",Pallars Jussà,252271,760,Matching,Non-matching
Torrefarrera,4605,2328,2277,25228,Torrefarrera,13,"5,6",14,"6,0",27,"5,9",Torrefarrera,Segrià,252287,4605,Matching,Matching
Torregrossa,2202,1140,1062,25230,Torregrossa,6,"5,3",3,"2,6",9,"4,1",Torregrossa,Pla d'Urgell,252304,2202,Matching,Matching
Torrelameu,743,433,310,25231,Torrelameu,0,"0,0",2,"4,6",2,"2,7",Torrelameu,Noguera,252311,743,Matching,Matching
Torres de Segre,2277,1179,1098,25232,Torres del Segre,26,"22,1",10,"8,5",36,"15,8",Torres de Segre,Segrià,252326,2277,Matching,Matching
Torre-serona,397,208,189,25233,Torre-Serona,1,"4,8",1,"4,8",2,"5,0",Torre-serona,Segrià,252332,397,Matching,Matching
Tremp,5844,2884,2960,25234,Tremp,42,"14,6",19,"6,6",61,"10,4",Tremp,Pallars Jussà,252347,5844,Matching,Matching
Vallbona de les Monges,233,120,113,25238,Vallbona de les Monges,0,"0,0",2,"16,7",2,"8,6",Vallbona de les Monges,Urgell,252385,233,Matching,Matching
"Valls de Valira, Les",791,412,379,25239,Les Valls de Valira,0,"0,0",1,"2,4",1,"1,3","Valls de Valira, les",Alt Urgell,252398,791,Matching,Matching
Vallfogona de Balaguer,1876,937,939,25240,Vallfogona de Balaguer,7,"7,5",1,"1,1",8,"4,3",Vallfogona de Balaguer,Noguera,252402,1876,Matching,Matching
Verdú,919,441,478,25242,Verdú,7,"15,9",2,"4,5",9,"9,8",Verdú,Urgell,252424,919,Matching,Matching
Vielha e Mijaran,5559,2837,2722,25243,Vielha e Mijaran,52,"18,3",29,"10,2",81,"14,6",Vielha e Mijaran,Val d'Aran,252430,5559,Matching,Matching
Vilagrassa,541,278,263,25244,Vilagrassa,2,"7,2",3,"10,8",5,"9,2",Vilagrassa,Urgell,252445,541,Matching,Matching
Vilaller,561,294,267,25245,Vilaller,1,"3,4",0,"0,0",1,"1,8",Vilaller,Alta Ribagorça,252458,561,Matching,Matching
Vilamòs,187,100,87,25247,Vilamòs,0,"0,0",0,"0,0",0,"0,0",Vilamòs,Val d'Aran,252477,187,Matching,Non-matching
Vilanova de Bellpuig,1181,599,582,25248,Vilanova de Bellpuig,5,"8,3",2,"3,3",7,"5,9",Vilanova de Bellpuig,Pla d'Urgell,252483,1181,Matching,Matching
Vilanova de l'Aguda,197,97,100,25249,Vilanova de l'Aguda,0,"0,0",0,"0,0",0,"0,0",Vilanova de l'Aguda,Noguera,252496,197,Matching,Non-matching
Vilanova de Meià,389,223,166,25250,Vilanova de Meià,1,"4,5",0,"0,0",1,"2,6",Vilanova de Meià,Noguera,252509,389,Matching,Matching
Vilanova de Segrià,977,518,459,25251,Vilanova de Segrià,3,"5,8",4,"7,7",7,"7,2",Vilanova de Segrià,Segrià,252516,977,Matching,Matching
Vila-sana,742,376,366,25252,Vila-Sana,3,"8,0",1,"2,7",4,"5,4",Vila-sana,Pla d'Urgell,252521,742,Matching,Matching
"Vilosell, El",169,88,81,25253,"Vilosell, El",0,"0,0",0,"0,0",0,"0,0","Vilosell, el",Garrigues,252537,169,Matching,Non-matching
Vilanova de la Barca,1036,535,501,25254,Vilanova de la Barca,11,"20,6",4,"7,5",15,"14,5",Vilanova de la Barca,Segrià,252542,1036,Matching,Matching
Vinaixa,470,249,221,25255,Vinaixa,1,"4,0",1,"4,0",2,"4,3",Vinaixa,Garrigues,252555,470,Matching,Matching
Vall de Cardós,364,195,169,25901,La Vall de Cardós,0,"0,0",1,"5,1",1,"2,7",Vall de Cardós,Pallars Sobirà,259010,364,Matching,Matching
Sant Martí de Riucorb,646,334,312,25902,Sant Martí de Riucorb,3,"9,0",1,"3,0",4,"6,2",Sant Martí de Riucorb,Urgell,259025,646,Matching,Matching
"Guingueta d'Àneu, La",297,159,138,25903,La Guingueta d'Àneu,1,"6,3",1,"6,3",2,"6,7","Guingueta d'Àneu, la",Pallars Sobirà,259031,297,Matching,Matching
Castell de Mur,183,104,79,25904,Castell de Mur,0,"0,0",0,"0,0",0,"0,0",Castell de Mur,Pallars Jussà,259046,183,Matching,Non-matching
Ribera d'Ondara,426,213,213,25905,Ribera d'Ondara,3,"14,1",0,"0,0",3,"7,0",Ribera d'Ondara,Segarra,259059,426,Matching,Matching
"Valls d'Aguilar, Les",260,145,115,25906,"Valls d'Aguilar, Les",0,"0,0",0,"0,0",0,"0,0","Valls d'Aguilar, les",Alt Urgell,259062,260,Matching,Non-matching
Torrefeta i Florejacs,602,322,280,25907,Torrefeta i florejacs,2,"6,2",2,"6,2",4,"6,6",Torrefeta i Florejacs,Segarra,259078,602,Matching,Matching
Fígols i Alinyà,252,145,107,25908,Fígols i Alinyà,0,"0,0",0,"0,0",0,"0,0",Fígols i Alinyà,Alt Urgell,259084,252,Matching,Non-matching
"Vansa i Fórnols, La",161,84,77,25909,"Vansa i Fórnols, La",0,"0,0",0,"0,0",0,"0,0","Vansa i Fórnols, la",Alt Urgell,259097,161,Matching,Non-matching
Josa i Tuixén,106,58,48,25910,Josa i Tuixén,0,"0,0",0,"0,0",0,"0,0",Josa i Tuixén,Alt Urgell,259101,106,Matching,Non-matching
"Plans de Sió, Els",506,272,234,25911,"Plans de Sió, Els",0,"0,0",0,"0,0",0,"0,0","Plans de Sió, els",Segarra,259118,506,Matching,Non-matching
Gimenells i el Pla de la Font,1111,595,516,25912,Gimenells i el Pla de la Font,7,"11,8",2,"3,4",9,"8,1",Gimenells i el Pla de la Font,Segrià,259123,1111,Matching,Matching
Riu de Cerdanya,93,55,38,25913,Riu de Cerdanya,0,"0,0",0,"0,0",0,"0,0",Riu de Cerdanya,Cerdanya,259139,93,Matching,Non-matching
Aiguamúrcia,901,465,436,43001,Aiguamúrcia,3,"6,5",3,"6,5",6,"6,7",Aiguamúrcia,Alt Camp,430017,901,Matching,Matching
Albinyana,2438,1243,1195,43002,Albinyana,7,"5,6",7,"5,6",14,"5,7",Albinyana,Baix Penedès,430022,2438,Matching,Matching
"Albiol, L'",485,253,232,43003,l'Albiol,2,"7,9",2,"7,9",4,"8,2","Albiol, l'",Baix Camp,430038,485,Matching,Matching
Alcanar,9418,4748,4670,43004,Alcanar,26,"5,5",6,"1,3",32,"3,4",Alcanar,Montsià,430043,9418,Matching,Matching
Alcover,5064,2499,2565,43005,Alcover,7,"2,8",6,"2,4",13,"2,6",Alcover,Alt Camp,430056,5064,Matching,Matching
Aldover,882,445,437,43006,Aldover,4,"9,0",0,"0,0",4,"4,5",Aldover,Baix Ebre,430069,882,Matching,Matching
"Aleixar, L'",873,450,423,43007,L'Aleixar,4,"8,9",3,"6,7",7,"8,0","Aleixar, l'",Baix Camp,430075,873,Matching,Matching
Alfara de Carles,377,199,178,43008,Alfara de Carles,0,"0,0",0,"0,0",0,"0,0",Alfara de Carles,Baix Ebre,430081,377,Matching,Non-matching
Alforja,1801,921,880,43009,Alforja,8,"8,7",3,"3,3",11,"6,1",Alforja,Baix Camp,430094,1801,Matching,Matching
Alió,439,208,231,43010,Alió,1,"4,8",1,"4,8",2,"4,6",Alió,Alt Camp,430108,439,Matching,Matching
Almoster,1351,680,671,43011,Almoster,6,"8,8",4,"5,9",10,"7,4",Almoster,Baix Camp,430115,1351,Matching,Matching
Altafulla,5243,2555,2688,43012,Altafulla,9,"3,5",6,"2,3",15,"2,9",Altafulla,Tarragonès,430120,5243,Matching,Matching
"Ametlla de Mar, L'",6787,3384,3403,43013,L'Ametlla de Mar,14,"4,1",6,"1,8",20,"2,9","Ametlla de Mar, l'",Baix Ebre,430136,6787,Matching,Matching
Amposta,20738,10449,10289,43014,Amposta,49,"4,7",30,"2,9",79,"3,8",Amposta,Montsià,430141,20738,Matching,Matching
Arbolí,137,79,58,43015,Arbolí,0,"0,0",0,"0,0",0,"0,0",Arbolí,Baix Camp,430154,137,Matching,Non-matching
"Arboç, L'",5517,2852,2665,43016,L'Arboç,17,"6,0",12,"4,2",29,"5,3","Arboç, l'",Baix Penedès,430167,5517,Matching,Matching
"Argentera, L'",124,70,54,43017,"Argentera, L'",0,"0,0",0,"0,0",0,"0,0","Argentera, l'",Baix Camp,430173,124,Matching,Non-matching
Arnes,455,224,231,43018,Arnes,0,"0,0",2,"8,9",2,"4,4",Arnes,Terra Alta,430189,455,Matching,Matching
Ascó,1660,856,804,43019,Ascó,4,"4,7",1,"1,2",5,"3,0",Ascó,Ribera d'Ebre,430192,1660,Matching,Matching
Banyeres del Penedès,3170,1612,1558,43020,Banyeres del Penedès,8,"5,0",7,"4,3",15,"4,7",Banyeres del Penedès,Baix Penedès,430206,3170,Matching,Matching
Barberà de la Conca,473,257,216,43021,Barberà de la Conca,1,"3,9",0,"0,0",1,"2,1",Barberà de la Conca,Conca de Barberà,430213,473,Matching,Matching
Batea,1890,944,946,43022,Batea,4,"4,2",3,"3,2",7,"3,7",Batea,Terra Alta,430228,1890,Matching,Matching
Bellmunt del Priorat,280,145,135,43023,Bellmunt del Priorat,2,"13,8",2,"13,8",4,"14,3",Bellmunt del Priorat,Priorat,430234,280,Matching,Matching
Bellvei,2203,1132,1071,43024,Bellvei,3,"2,7",4,"3,5",7,"3,2",Bellvei,Baix Penedès,430249,2203,Matching,Matching
Benifallet,739,348,391,43025,Benifallet,1,"2,9",2,"5,7",3,"4,1",Benifallet,Baix Ebre,430252,739,Matching,Matching
Benissanet,1161,646,515,43026,Benissanet,1,"1,5",2,"3,1",3,"2,6",Benissanet,Ribera d'Ebre,430265,1161,Matching,Matching
"Bisbal de Falset, La",216,116,100,43027,La Bisbal de Falset,0,"0,0",0,"0,0",0,"0,0","Bisbal de Falset, la",Priorat,430271,216,Matching,Non-matching
"Bisbal del Penedès, La",3528,1862,1666,43028,La Bisbal del Penedès,7,"3,8",6,"3,2",13,"3,7","Bisbal del Penedès, la",Baix Penedès,430287,3528,Matching,Matching
Blancafort,389,198,191,43029,Blancafort,0,"0,0",0,"0,0",0,"0,0",Blancafort,Conca de Barberà,430290,389,Matching,Non-matching
Bonastre,688,357,331,43030,Bonastre,0,"0,0",0,"0,0",0,"0,0",Bonastre,Baix Penedès,430304,688,Matching,Non-matching
"Borges del Camp, Les",2037,1050,987,43031,Les Borges del Camp,5,"4,8",2,"1,9",7,"3,4","Borges del Camp, les",Baix Camp,430311,2037,Matching,Matching
Bot,573,295,278,43032,Bot,0,"0,0",1,"3,4",1,"1,7",Bot,Terra Alta,430326,573,Matching,Matching
Botarell,1068,549,519,43033,Botarell,2,"3,6",3,"5,5",5,"4,7",Botarell,Baix Camp,430332,1068,Matching,Matching
Bràfim,692,357,335,43034,Bràfim,4,"11,2",3,"8,4",7,"10,1",Bràfim,Alt Camp,430347,692,Matching,Matching
Cabacés,298,155,143,43035,Cabacés,2,"12,9",0,"0,0",2,"6,7",Cabacés,Priorat,430350,298,Matching,Matching
Cabra del Camp,1163,608,555,43036,Cabra del Camp,5,"8,2",2,"3,3",7,"6,0",Cabra del Camp,Alt Camp,430363,1163,Matching,Matching
Calafell,26538,13362,13176,43037,Calafell,52,"3,9",46,"3,4",98,"3,7",Calafell,Baix Penedès,430379,26538,Matching,Matching
Cambrils,33898,16553,17345,43038,Cambrils,103,"6,2",61,"3,7",164,"4,8",Cambrils,Baix Camp,430385,33898,Matching,Matching
Capafonts,121,62,59,43039,Capafonts,0,"0,0",0,"0,0",0,"0,0",Capafonts,Baix Camp,430398,121,Matching,Non-matching
Capçanes,398,202,196,43040,Capçanes,1,"5,0",0,"0,0",1,"2,5",Capçanes,Priorat,430402,398,Matching,Matching
Caseres,259,129,130,43041,Caseres,2,"15,5",1,"7,8",3,"11,6",Caseres,Terra Alta,430419,259,Matching,Matching
Castellvell del Camp,2857,1438,1419,43042,Castellvell del Camp,4,"2,8",6,"4,2",10,"3,5",Castellvell del Camp,Baix Camp,430424,2857,Matching,Matching
"Catllar, El",4451,2309,2142,43043,El Catllar,11,"4,8",5,"2,2",16,"3,6","Catllar, el",Tarragonès,430430,4451,Matching,Matching
"Sénia, La",5681,2844,2837,43044,La Sénia,6,"2,1",7,"2,5",13,"2,3","Sénia, la",Montsià,430445,5681,Matching,Matching
Colldejou,176,93,83,43045,Colldejou,0,"0,0",0,"0,0",0,"0,0",Colldejou,Baix Camp,430458,176,Matching,Non-matching
Conesa,103,54,49,43046,Conesa,0,"0,0",0,"0,0",0,"0,0",Conesa,Conca de Barberà,430461,103,Matching,Non-matching
Constantí,6540,3398,3142,43047,Constantí,19,"5,6",14,"4,1",33,"5,0",Constantí,Tarragonès,430477,6540,Matching,Matching
Corbera d'Ebre,1016,531,485,43048,Corbera d'Ebre,3,"5,6",0,"0,0",3,"3,0",Corbera d'Ebre,Terra Alta,430483,1016,Matching,Matching
Cornudella de Montsant,941,505,436,43049,Cornudella de Montsant,3,"5,9",2,"4,0",5,"5,3",Cornudella de Montsant,Priorat,430496,941,Matching,Matching
Creixell,3642,1845,1797,43050,Creixell,11,"6,0",9,"4,9",20,"5,5",Creixell,Tarragonès,430509,3642,Matching,Matching
Cunit,12952,6347,6605,43051,Cunit,57,"9,0",38,"6,0",95,"7,3",Cunit,Baix Penedès,430516,12952,Matching,Matching
Xerta,1170,571,599,43052,Xerta,7,"12,3",1,"1,8",8,"6,8",Xerta,Baix Ebre,430521,1170,Matching,Matching
Duesaigües,245,140,105,43053,Duesaigües,0,"0,0",1,"7,1",1,"4,1",Duesaigües,Baix Camp,430537,245,Matching,Matching
"Espluga de Francolí, L'",3755,1824,1931,43054,L'Espluga de Francolí,7,"3,8",7,"3,8",14,"3,7","Espluga de Francolí, l'",Conca de Barberà,430542,3755,Matching,Matching
Falset,2834,1412,1422,43055,Falset,15,"10,6",6,"4,2",21,"7,4",Falset,Priorat,430555,2834,Matching,Matching
"Fatarella, La",941,458,483,43056,La Fatarella,0,"0,0",2,"4,4",2,"2,1","Fatarella, la",Terra Alta,430568,941,Matching,Matching
"Febró, La",40,25,15,43057,La Febró,0,"0,0",0,"0,0",0,"0,0","Febró, la",Baix Camp,430574,40,Matching,Non-matching
"Figuera, La",111,63,48,43058,La Figuera,0,"0,0",0,"0,0",0,"0,0","Figuera, la",Priorat,430580,111,Matching,Non-matching
Figuerola del Camp,320,159,161,43059,Figuerola del Camp,2,"12,6",2,"12,6",4,"12,5",Figuerola del Camp,Alt Camp,430593,320,Matching,Matching
Flix,3408,1717,1691,43060,Flix,11,"6,4",5,"2,9",16,"4,7",Flix,Ribera d'Ebre,430607,3408,Matching,Matching
Forès,43,25,18,43061,Forès,0,"0,0",0,"0,0",0,"0,0",Forès,Conca de Barberà,430614,43,Matching,Non-matching
Freginals,346,175,171,43062,Freginals,1,"5,7",0,"0,0",1,"2,9",Freginals,Montsià,430629,346,Matching,Matching
"Galera, La",731,375,356,43063,La Galera,1,"2,7",0,"0,0",1,"1,4","Galera, la",Montsià,430635,731,Matching,Matching
Gandesa,3064,1563,1501,43064,Gandesa,5,"3,2",3,"1,9",8,"2,6",Gandesa,Terra Alta,430640,3064,Matching,Matching
Garcia,527,264,263,43065,Garcia,1,"3,8",1,"3,8",2,"3,8",Garcia,Ribera d'Ebre,430653,527,Matching,Matching
"Garidells, Els",187,94,93,43066,Els Garidells,0,"0,0",0,"0,0",0,"0,0","Garidells, els",Alt Camp,430666,187,Matching,Non-matching
Ginestar,753,403,350,43067,Ginestar,4,"9,9",2,"5,0",6,"8,0",Ginestar,Ribera d'Ebre,430672,753,Matching,Matching
Godall,575,289,286,43068,Godall,2,"6,9",0,"0,0",2,"3,5",Godall,Montsià,430688,575,Matching,Matching
Gratallops,229,125,104,43069,Gratallops,0,"0,0",0,"0,0",0,"0,0",Gratallops,Priorat,430691,229,Matching,Non-matching
"Guiamets, Els",270,128,142,43070,Els Guiamets,1,"7,8",3,"23,4",4,"14,8","Guiamets, els",Priorat,430705,270,Matching,Matching
Horta de Sant Joan,1149,602,547,43071,Horta de Sant Joan,1,"1,7",1,"1,7",2,"1,7",Horta de Sant Joan,Terra Alta,430712,1149,Matching,Matching
"Lloar, El",107,58,49,43072,El Lloar,0,"0,0",0,"0,0",0,"0,0","Lloar, el",Priorat,430727,107,Matching,Non-matching
Llorac,100,52,48,43073,Llorac,0,"0,0",0,"0,0",0,"0,0",Llorac,Conca de Barberà,430733,100,Matching,Non-matching
Llorenç del Penedès,2393,1172,1221,43074,Llorenç del Penedès,8,"6,8",7,"6,0",15,"6,3",Llorenç del Penedès,Baix Penedès,430748,2393,Matching,Matching
Margalef,97,59,38,43075,Margalef,0,"0,0",0,"0,0",0,"0,0",Margalef,Priorat,430751,97,Matching,Non-matching
Marçà,594,314,280,43076,Marçà,3,"9,6",1,"3,2",4,"6,7",Marçà,Priorat,430764,594,Matching,Matching
Mas de Barberans,578,288,290,43077,Mas de Barberans,1,"3,5",1,"3,5",2,"3,5",Mas de Barberans,Montsià,430770,578,Matching,Matching
Masdenverge,1070,546,524,43078,Masdenverge,1,"1,8",0,"0,0",1,"0,9",Masdenverge,Montsià,430786,1070,Matching,Matching
Masllorenç,504,283,221,43079,Masllorenç,1,"3,5",0,"0,0",1,"2,0",Masllorenç,Baix Penedès,430799,504,Matching,Matching
"Masó, La",276,146,130,43080,La Masó,1,"6,8",1,"6,8",2,"7,2","Masó, la",Alt Camp,430803,276,Matching,Matching
Maspujols,827,426,401,43081,Maspujols,0,"0,0",2,"4,7",2,"2,4",Maspujols,Baix Camp,430810,827,Matching,Matching
"Masroig, El",497,270,227,43082,El Masroig,3,"11,1",0,"0,0",3,"6,0","Masroig, el",Priorat,430825,497,Matching,Matching
"Milà, El",178,85,93,43083,El Milà,0,"0,0",0,"0,0",0,"0,0","Milà, el",Alt Camp,430831,178,Matching,Non-matching
Miravet,691,369,322,43084,Miravet,2,"5,4",0,"0,0",2,"2,9",Miravet,Ribera d'Ebre,430846,691,Matching,Matching
"Molar, El",297,158,139,43085,El Molar,0,"0,0",2,"12,7",2,"6,7","Molar, el",Priorat,430859,297,Matching,Matching
Montblanc,7364,3737,3627,43086,Montblanc,17,"4,5",14,"3,7",31,"4,2",Montblanc,Conca de Barberà,430862,7364,Matching,Matching
Montbrió del Camp,2890,1485,1405,43088,Montbrió del Camp,7,"4,7",4,"2,7",11,"3,8",Montbrió del Camp,Baix Camp,430884,2890,Matching,Matching
Montferri,387,202,185,43089,Montferri,0,"0,0",1,"5,0",1,"2,6",Montferri,Alt Camp,430897,387,Matching,Matching
"Montmell, El",1512,808,704,43090,El Montmell,2,"2,5",3,"3,7",5,"3,3","Montmell, el",Baix Penedès,430901,1512,Matching,Matching
Mont-ral,162,94,68,43091,Mont-ral,0,"0,0",0,"0,0",0,"0,0",Mont-ral,Alt Camp,430918,162,Matching,Non-matching
Mont-roig del Camp,12136,6260,5876,43092,Mont-Roig del Camp,13,"2,1",17,"2,7",30,"2,5",Mont-roig del Camp,Baix Camp,430923,12136,Matching,Matching
Móra d'Ebre,5690,2845,2845,43093,Móra d'Ebre,19,"6,7",5,"1,8",24,"4,2",Móra d'Ebre,Ribera d'Ebre,430939,5690,Matching,Matching
Móra la Nova,3087,1541,1546,43094,Móra la Nova,9,"5,8",5,"3,2",14,"4,5",Móra la Nova,Ribera d'Ebre,430944,3087,Matching,Matching
"Morell, El",3704,1881,1823,43095,El Morell,12,"6,4",2,"1,1",14,"3,8","Morell, el",Tarragonès,430957,3704,Matching,Matching
"Morera de Montsant, La",152,85,67,43096,La Morera de Montsant,0,"0,0",0,"0,0",0,"0,0","Morera de Montsant, la",Priorat,430960,152,Matching,Non-matching
"Nou de Gaià, La",603,300,303,43097,La Nou de Gaià,0,"0,0",0,"0,0",0,"0,0","Nou de Gaià, la",Tarragonès,430976,603,Matching,Non-matching
Nulles,492,267,225,43098,Nulles,1,"3,7",1,"3,7",2,"4,1",Nulles,Alt Camp,430982,492,Matching,Matching
"Palma d'Ebre, La",340,166,174,43099,La Palma d'Ebre,1,"6,0",1,"6,0",2,"5,9","Palma d'Ebre, la",Ribera d'Ebre,430995,340,Matching,Matching
"Pallaresos, Els",4777,2404,2373,43100,Els Pallaresos,46,"19,1",17,"7,1",63,"13,2","Pallaresos, els",Tarragonès,431009,4777,Matching,Matching
Passanant i Belltall,163,95,68,43101,Passanant i Belltall,0,"0,0",0,"0,0",0,"0,0",Passanant i Belltall,Conca de Barberà,431016,163,Matching,Non-matching
Paüls,556,277,279,43102,Paüls,1,"3,6",0,"0,0",1,"1,8",Paüls,Baix Ebre,431021,556,Matching,Matching
Perafort,1261,654,607,43103,Perafort,4,"6,1",2,"3,1",6,"4,8",Perafort,Tarragonès,431037,1261,Matching,Matching
"Perelló, El",2770,1421,1349,43104,El Perelló,3,"2,1",2,"1,4",5,"1,8","Perelló, el",Baix Ebre,431042,2770,Matching,Matching
"Piles, Les",212,120,92,43105,"Piles, Les",0,"0,0",0,"0,0",0,"0,0","Piles, les",Conca de Barberà,431055,212,Matching,Non-matching
"Pinell de Brai, El",1017,516,501,43106,El Pinell de Brai,0,"0,0",0,"0,0",0,"0,0","Pinell de Brai, el",Terra Alta,431068,1017,Matching,Non-matching
Pira,493,261,232,43107,Pira,1,"3,8",2,"7,7",3,"6,1",Pira,Conca de Barberà,431074,493,Matching,Matching
"Pla de Santa Maria, El",2327,1215,1112,43108,El Pla de Santa Maria,5,"4,1",4,"3,3",9,"3,9","Pla de Santa Maria, el",Alt Camp,431080,2327,Matching,Matching
"Pobla de Mafumet, La",3904,1982,1922,43109,La Pobla de Mafumet,13,"6,6",3,"1,5",16,"4,1","Pobla de Mafumet, la",Tarragonès,431093,3904,Matching,Matching
"Pobla de Massaluca, La",318,181,137,43110,La Pobla de Massaluca,2,"11,0",2,"11,0",4,"12,6","Pobla de Massaluca, la",Terra Alta,431107,318,Matching,Matching
"Pobla de Montornès, La",2839,1486,1353,43111,La Pobla de Montornès,1,"0,7",3,"2,0",4,"1,4","Pobla de Montornès, la",Tarragonès,431114,2839,Matching,Matching
Poboleda,313,166,147,43112,Poboleda,1,"6,0",0,"0,0",1,"3,2",Poboleda,Priorat,431129,313,Matching,Matching
"Pont d'Armentera, El",505,258,247,43113,El Pont d'Armentera,2,"7,8",1,"3,9",3,"5,9","Pont d'Armentera, el",Alt Camp,431135,505,Matching,Matching
Porrera,439,229,210,43114,Porrera,2,"8,7",2,"8,7",4,"9,1",Porrera,Priorat,431140,439,Matching,Matching
Pradell de la Teixeta,152,70,82,43115,Pradell de la Teixeta,0,"0,0",0,"0,0",0,"0,0",Pradell de la Teixeta,Priorat,431153,152,Matching,Non-matching
Prades,589,309,280,43116,Prades,1,"3,2",2,"6,5",3,"5,1",Prades,Baix Camp,431166,589,Matching,Matching
Prat de Comte,183,98,85,43117,Prat de Comte,0,"0,0",0,"0,0",0,"0,0",Prat de Comte,Terra Alta,431172,183,Matching,Non-matching
Pratdip,738,395,343,43118,Pratdip,1,"2,5",1,"2,5",2,"2,7",Pratdip,Baix Camp,431188,738,Matching,Matching
Puigpelat,1149,590,559,43119,Puigpelat,1,"1,7",1,"1,7",2,"1,7",Puigpelat,Alt Camp,431191,1149,Matching,Matching
Querol,507,285,222,43120,Querol,0,"0,0",0,"0,0",0,"0,0",Querol,Alt Camp,431205,507,Matching,Non-matching
Rasquera,781,384,397,43121,Rasquera,3,"7,8",0,"0,0",3,"3,8",Rasquera,Ribera d'Ebre,431212,781,Matching,Matching
Renau,157,82,75,43122,Renau,0,"0,0",0,"0,0",0,"0,0",Renau,Tarragonès,431227,157,Matching,Non-matching
Reus,104373,50415,53958,43123,Reus,361,"7,2",237,"4,7",598,"5,7",Reus,Baix Camp,431233,104373,Matching,Matching
"Riba, La",585,321,264,43124,La Riba,0,"0,0",0,"0,0",0,"0,0","Riba, la",Alt Camp,431248,585,Matching,Non-matching
Riba-roja d'Ebre,1126,593,533,43125,Riba-Roja d'Ebre,0,"0,0",2,"3,4",2,"1,8",Riba-roja d'Ebre,Ribera d'Ebre,431251,1126,Matching,Matching
"Riera de Gaià, La",1744,867,877,43126,La Riera de Gaià,1,"1,2",2,"2,3",3,"1,7","Riera de Gaià, la",Tarragonès,431264,1744,Matching,Matching
Riudecanyes,1124,590,534,43127,Riudecanyes,0,"0,0",2,"3,4",2,"1,8",Riudecanyes,Baix Camp,431270,1124,Matching,Matching
Riudecols,1180,611,569,43128,Riudecols,1,"1,6",0,"0,0",1,"0,8",Riudecols,Baix Camp,431286,1180,Matching,Matching
Riudoms,6594,3380,3214,43129,Riudoms,17,"5,0",10,"3,0",27,"4,1",Riudoms,Baix Camp,431299,6594,Matching,Matching
Rocafort de Queralt,225,122,103,43130,Rocafort de Queralt,1,"8,2",1,"8,2",2,"8,9",Rocafort de Queralt,Conca de Barberà,431303,225,Matching,Matching
Roda de Berà,6567,3341,3226,43131,Roda de Berà,5,"1,5",14,"4,2",19,"2,9",Roda de Berà,Tarragonès,431310,6567,Matching,Matching
Rodonyà,490,262,228,43132,Rodonyà,1,"3,8",3,"11,5",4,"8,2",Rodonyà,Alt Camp,431325,490,Matching,Matching
Roquetes,7973,4126,3847,43133,Roquetes,27,"6,5",17,"4,1",44,"5,5",Roquetes,Baix Ebre,431331,7973,Matching,Matching
"Rourell, El",366,191,175,43134,El Rourell,0,"0,0",0,"0,0",0,"0,0","Rourell, el",Alt Camp,431346,366,Matching,Non-matching
Salomó,557,295,262,43135,Salomó,0,"0,0",0,"0,0",0,"0,0",Salomó,Tarragonès,431359,557,Matching,Non-matching
Sant Carles de la Ràpita,14789,7238,7551,43136,Sant Carles de la Ràpita,31,"4,3",15,"2,1",46,"3,1",Sant Carles de la Ràpita,Montsià,431362,14789,Matching,Matching
Sant Jaume dels Domenys,2622,1342,1280,43137,Sant Jaume dels Domenys,5,"3,7",2,"1,5",7,"2,7",Sant Jaume dels Domenys,Baix Penedès,431378,2622,Matching,Matching
Santa Bàrbara,3707,1881,1826,43138,Santa Bàrbara,7,"3,7",6,"3,2",13,"3,5",Santa Bàrbara,Montsià,431384,3707,Matching,Matching
Santa Coloma de Queralt,2673,1328,1345,43139,Santa Coloma de Queralt,18,"13,6",9,"6,8",27,"10,1",Santa Coloma de Queralt,Conca de Barberà,431397,2673,Matching,Matching
Santa Oliva,3320,1685,1635,43140,Santa Oliva,8,"4,7",8,"4,7",16,"4,8",Santa Oliva,Baix Penedès,431401,3320,Matching,Matching
Pontils,117,66,51,43141,Pontils,0,"0,0",0,"0,0",0,"0,0",Pontils,Conca de Barberà,431418,117,Matching,Non-matching
Sarral,1548,789,759,43142,Sarral,2,"2,5",5,"6,3",7,"4,5",Sarral,Conca de Barberà,431423,1548,Matching,Matching
Savallà del Comtat,58,31,27,43143,Savallà del Comtat,0,"0,0",0,"0,0",0,"0,0",Savallà del Comtat,Conca de Barberà,431439,58,Matching,Non-matching
"Secuita, La",1687,851,836,43144,La Secuita,9,"10,6",0,"0,0",9,"5,3","Secuita, la",Tarragonès,431444,1687,Matching,Matching
"Selva del Camp, La",5652,2836,2816,43145,La Selva del Camp,16,"5,6",13,"4,6",29,"5,1","Selva del Camp, la",Baix Camp,431457,5652,Matching,Matching
Senan,48,33,15,43146,Senan,0,"0,0",0,"0,0",0,"0,0",Senan,Conca de Barberà,431460,48,Matching,Non-matching
Solivella,633,333,300,43147,Solivella,3,"9,0",1,"3,0",4,"6,3",Solivella,Conca de Barberà,431476,633,Matching,Matching
Tarragona,134515,65505,69010,43148,Tarragona,542,"8,3",351,"5,4",893,"6,6",Tarragona,Tarragonès,431482,134515,Matching,Matching
Tivenys,899,458,441,43149,Tivenys,1,"2,2",0,"0,0",1,"1,1",Tivenys,Baix Ebre,431495,899,Matching,Matching
Tivissa,1602,799,803,43150,Tivissa,0,"0,0",3,"3,8",3,"1,9",Tivissa,Ribera d'Ebre,431508,1602,Matching,Matching
"Torre de Fontaubella, La",138,68,70,43151, La Torre de Fontaubella,0,"0,0",0,"0,0",0,"0,0","Torre de Fontaubella, la",Priorat,431515,138,Matching,Non-matching
"Torre de l'Espanyol, La",611,311,300,43152,La Torre de l'Espanyol,2,"6,4",0,"0,0",2,"3,3","Torre de l'Espanyol, la",Ribera d'Ebre,431520,611,Matching,Matching
Torredembarra,16184,7925,8259,43153,Torredembarra,20,"2,5",28,"3,5",48,"3,0",Torredembarra,Tarragonès,431536,16184,Matching,Matching
Torroja del Priorat,149,81,68,43154,Torroja del Priorat,0,"0,0",0,"0,0",0,"0,0",Torroja del Priorat,Priorat,431541,149,Matching,Non-matching
Tortosa,33372,16496,16876,43155,Tortosa,164,"9,9",78,"4,7",242,"7,3",Tortosa,Baix Ebre,431554,33372,Matching,Matching
Ulldecona,6300,3286,3014,43156,Ulldecona,8,"2,4",5,"1,5",13,"2,1",Ulldecona,Montsià,431567,6300,Matching,Matching
Ulldemolins,396,229,167,43157,Ulldemolins,1,"4,4",0,"0,0",1,"2,5",Ulldemolins,Priorat,431573,396,Matching,Matching
Vallclara,98,57,41,43158,Vallclara,0,"0,0",0,"0,0",0,"0,0",Vallclara,Conca de Barberà,431589,98,Matching,Non-matching
Vallfogona de Riucorb,91,55,36,43159,Vallfogona de Riucorb,0,"0,0",0,"0,0",0,"0,0",Vallfogona de Riucorb,Conca de Barberà,431592,91,Matching,Non-matching
Vallmoll,1756,890,866,43160,Vallmoll,2,"2,2",4,"4,5",6,"3,4",Vallmoll,Alt Camp,431606,1756,Matching,Matching
Valls,24359,12210,12149,43161,Valls,94,"7,7",78,"6,4",172,"7,1",Valls,Alt Camp,431613,24359,Matching,Matching
Vandellòs i l'Hospitalet de l'Infant,6482,3246,3236,43162,Vandellòs i l'Hospitalet de l'Infant,13,"4,0",12,"3,7",25,"3,9",Vandellòs i l'Hospitalet de l'Infant,Baix Camp,431628,6482,Matching,Matching
"Vendrell, El",37606,18631,18975,43163,El Vendrell,83,"4,5",76,"4,1",159,"4,2","Vendrell, el",Baix Penedès,431634,37606,Matching,Matching
Vespella de Gaià,410,232,178,43164,Vespella,0,"0,0",2,"8,6",2,"4,9",Vespella de Gaià,Tarragonès,431649,410,Matching,Matching
Vilabella,736,378,358,43165,Vilabella,3,"7,9",4,"10,6",7,"9,5",Vilabella,Alt Camp,431652,736,Matching,Matching
Vilallonga del Camp,2389,1206,1183,43166,Vilallonga del Camp,9,"7,5",6,"5,0",15,"6,3",Vilallonga del Camp,Tarragonès,431665,2389,Matching,Matching
Vilanova d'Escornalbou,545,288,257,43167,Vilanova d'Escornalbou,0,"0,0",2,"6,9",2,"3,7",Vilanova d'Escornalbou,Baix Camp,431671,545,Matching,Matching
Vilanova de Prades,112,60,52,43168,Vilanova de Prades,0,"0,0",0,"0,0",0,"0,0",Vilanova de Prades,Conca de Barberà,431687,112,Matching,Non-matching
Vilaplana,574,302,272,43169,Vilaplana,1,"3,3",3,"9,9",4,"7,0",Vilaplana,Baix Camp,431690,574,Matching,Matching
Vila-rodona,1255,660,595,43170,Vila-Rodona,2,"3,0",3,"4,5",5,"4,0",Vila-rodona,Alt Camp,431704,1255,Matching,Matching
Vila-seca,22187,11113,11074,43171,Vila-Seca,28,"2,5",16,"1,4",44,"2,0",Vila-seca,Tarragonès,431711,22187,Matching,Matching
Vilaverd,452,240,212,43172,Vilaverd,1,"4,2",0,"0,0",1,"2,2",Vilaverd,Conca de Barberà,431726,452,Matching,Matching
"Vilella Alta, La",135,73,62,43173,La Vilella Alta,0,"0,0",0,"0,0",0,"0,0","Vilella Alta, la",Priorat,431732,135,Matching,Non-matching
"Vilella Baixa, La",202,113,89,43174,La Vilella Baixa,0,"0,0",0,"0,0",0,"0,0","Vilella Baixa, la",Priorat,431747,202,Matching,Non-matching
Vilalba dels Arcs,625,318,307,43175,Vilalba dels Arcs,0,"0,0",0,"0,0",0,"0,0",Vilalba dels Arcs,Terra Alta,431750,625,Matching,Non-matching
Vimbodí i Poblet,892,488,404,43176,Vimbodí i Poblet,1,"2,0",4,"8,2",5,"5,6",Vimbodí i Poblet,Conca de Barberà,431763,892,Matching,Matching
Vinebre,428,221,207,43177,Vinebre,0,"0,0",2,"9,0",2,"4,7",Vinebre,Ribera d'Ebre,431779,428,Matching,Matching
Vinyols i els Arcs,2056,1070,986,43178,Vinyols i  els Arcs,2,"1,9",4,"3,7",6,"2,9",Vinyols i els Arcs,Baix Camp,431785,2056,Matching,Matching
Deltebre,11482,5788,5694,43901,Deltebre,27,"4,7",19,"3,3",46,"4,0",Deltebre,Baix Ebre,439018,11482,Matching,Matching
Sant Jaume d'Enveja,3503,1765,1738,43902,Sant Jaume d'Enveja,6,"3,4",3,"1,7",9,"2,6",Sant Jaume d'Enveja,Montsià,439023,3503,Matching,Matching
Camarles,3224,1638,1586,43903,Camarles,3,"1,8",6,"3,7",9,"2,8",Camarles,Baix Ebre,439039,3224,Matching,Matching
"Aldea, L'",4160,2197,1963,43904,l'Aldea,6,"2,7",5,"2,3",11,"2,6","Aldea, l'",Baix Ebre,439044,4160,Matching,Matching
Salou,27476,14141,13335,43905,Salou,62,"4,4",63,"4,5",125,"4,5",Salou,Tarragonès,439057,27476,Matching,Matching
"Ampolla, L'",3205,1631,1574,43906,L'Ampolla,5,"3,1",4,"2,5",9,"2,8","Ampolla, l'",Baix Ebre,439060,3205,Matching,Matching
"Canonja, La",5893,2892,3001,43907,La Canonja,24,"8,3",12,"4,1",36,"6,1","Canonja, la",Tarragonès,439076,5893,Matching,Matching